amazing: tuyet voi
abandon: bo roi
about: bao gom
ability: co kha nang
above: phia tren
Add: them vao
Age: tuoi tac
And: va
Art: nghe thuat, my thuat
Aid: su giup do; them vao, phu vao
Ask: hoi
Any: bat ki
Ago: truoc day
Air: khong khi, bau khong khi, khong gian
Arm: canh tay; vu trang, trang bi
Act: hanh dong, hanh vi, cu chi, doi xu
Aim: muc tieu, y dinh
Area: khu vuc, dia diem
Aunt: co
Alow: oi chao
Army: quan doi
Away: xa cach, roi xa
Acid: axit
Also: cung, cung vay, cung the
Atom: nguyen tu
Auto: tu dong
Ally: nuoc dong minh, lien minh; lien ket, ket thong gia
Able: co nang luc, co tai
Apple: qua tao
Angel: thien than
Ankle: mat ca chan
Alive: song, van con song, con ton tai
Actor: dien vien
Agree: dong y, tan thanh
About: khoang
Apart: qua mot ben
Admit: thua nhan
Adapt: tra, lap vao
Again: lai, nua, lan nua
After: sau do
Along: doc theo
Abuse: long hanh, lam dung
Adult: truong thanh
Angry: tuc gian
Above: o tren
Amuse: lam cho vui, thich
Alter: thay doi, bien doi, sua doi
Annoy: choc tuc, lam buc minh
Ahead: truoc, ve phia truoc
Agent: dai ly, tac nhan
Awful: kinh khung
Allow: cho phep, de cho
Alarm: bao dong, bao nguy
Arise: xuat hien, nay ra
Among: o giua
Anger: su tuc gian
Argue: chung to, chi ro
Angle: goc
Alone: mot minh, co don
Aloud: lon tieng
Arrow: ten, mui ten
Aware: nhan thuc
Adopt: nhan lam con nuoi, bo me nuoi
Aspect: ve be ngoai, dien mao
Avoid: tranh xa
Awake: lam thuc day
Award: phan thuong
Animal: dong vat
Author: tac gia
Autumn: mua thu
August: thang tam
Admire: kham phuc, than phuc
Answer: su tra loi, tra loi
Artist: nghe si
Amount: so tien
Across: qua, ngang qua
Anyone: bat cu ai
Arrest: bat giu, su bat giu
Appear: xuat hien
Afraid: so hai, hoang so
Appeal: su keu goi, loi keu goi
Actual: thuc te, co that
Always: luon luon
Accuse: to cao, buoc toi, ket toi
Anyway: the nao cung duoc
Around: xung quanh
Agency: tac dung, luc; moi gioi, trung gian
Advice: loi khuyen
Acting: dien xuat
Access: loi, cua, duong vao
Absorb: thu hut, loi cuon
Afford: co the, co du kha nang, dieu kien
Active: tich cuc hoat dong, nhanh nhen
Absent: vang mat, nghi
Affair: cong viec
Annual: hang nam, tung nam
Affect: lam anh huong, tac dong den
Accent: trong am, dau trong am
Arrive: den, toi noi
Action: hanh dong
Attack: tan cong, su tan cong
Almost: hau nhu, gan nhu
Adjust: sua lai cho dung, dieu chinh
Accept: chap nhan, chap thuan
Abroad: ra nuoc ngoai, ngoai troi
Assist: giup do, tham du, co mat
Assure: dam bao, cam doan
Attach: gan, dan, troi, buoc
Attend: du, co mat
Ability: co kha nang
Assumed: gia dinh
Achieve: dat duoc
Another: khac
Appoint: bo nhiem, chi dinh
Account: tai khoan
Awkward: vung ve, lung tung
Average: trung binh cong
Address: dia chi, de dia chi
Amazing: kinh ngac, sung sot
Absence: su vang mat
Alcohol: ruou con
Airport: san bay, phi truong
Against: chong lai
Ancient: xua, co
Attempt: co gang, no luc
Anxiety: moi lo au, su lo lang
Already: da san sang
Abandon: bo, tu bo
Article: bai bao
Actually: thuc ra
Academic: thuoc hoc vien, DH, vien han lam
Activity: hoat dong
Accepted: chap thuan
Although: mac du
Analysis: su phan tich
Anything: bat cu dieu gi
Absolute: tuyet doi, hoan toan
Adequate: day, day du
Approach: tiep can
Anywhere: bat cu noi dau
Anything: bat cu viec gi, vat gi
Accurate: dung dan, chinh xac
Addition: them vao
Ambition: hoai bao, khat vong
Approval: su tan thanh, dong y
Acquired: mua
Alphabet: bang chu cai, buoc dau, dieu co ban
Aircraft: may bay, khi cau
Accident: tai nan, rui ro
Achieved: da dat duoc
Attitude: thai do, quan diem
Attorney: nguoi duoc uy quyen
Analytics: phan tich
Accompany: dong hanh
Available: co san
Advantage: loi the
Assistant: phu ta
Allowance: tro cap
Ambulance: xe cuu thuong
Attention: su chu y
Afternoon: buoi chieu
Abandoned: bi bo roi, bi ruong bo
Apartment: can ho, chung cu
Anonymous: vo danh
Appearance: xuat hien
Ammunition: dan duoc
Assessment: tham dinh, luong dinh, danh gia
Affordable: gia ca phai chang
Attractive: hap dan
Accounting: ke toan
Anticipate: thay truoc, chan truoc
Atmosphere: khi quyen
Aggressive: xam luoc, hung hang
Appreciate: thay ro, nhan thuc
Admiration: su kham phuc
Acceptance: chap thuan
Accidental: tinh co, bat ngo
Afterwards: sau nay, ve sau, roi thi, sau day
Absolutely: tuyet doi, hoan toan
Assistance: ho tro
Adaptation: su thich nghi
Anniversary: ki niem
Advertising: quang cao
Achievement: thanh tich, thanh tuu
Attribution: su bieu hien, su tuong trung
Aquaculture: nuoi trong thuy san
Accommodate: cung cap, chua dung
Advancement: thang tien
Acknowledge: cong nhan, thua nhan
Assemblyman: nguoi trong hoi dong
Alternative: su lua chon, lua chon
Aggravation: lam tang them
Articulation: su khop noi
Architecture: nganh kien truc
Accidentally: tinh co, ngau nhien
Announcement: su thong bao
Appendicular: hinh thau kinh
Appreciative: danh gia cao
Authoritarian: doc tai
Administrator: nguoi quan ly
Administrated: quan ly
Advertisement: quang cao
Appropriation: chiem doat
Accomplishment: thanh qua
Afforestations: trong rung
Accommodations: cho o
Administration: su quan tri
Accountability: trach nhiem
Apocalypticism: thuyet khai huyen
Acknowledgments: su nhin nhan
Atherosclerosis: xo vua dong mach
Associationists: nhung nguoi theo chu nghia
Apprenticeships: hoc viec
Anticompetitive: phan canh tranh
Bad: te
Big: lon
Buy: mua
But: nhung
Boy: cau be
Bus: xe buyt
Ban: cam chi, su cam
Bet: ca cuoc
Box: hop
Bit: mieng, mot ti
Bee: con ong
Bed: giuong ngu
Bid: dau thau
Bay: gian, Vinh
Bag: cap, tui xach
Bye: tam biet
Bin: thung rac
Bar: quan bar
Bird: con chim
Body: than the
Busy: ban
Bell: cai chuong, tieng chuong
Blue: mau xanh
Blow: no hoa
Born: sinh
Boot: giay ong
Book: cuon sach, dat phong
Bowl: cai bat
Burn: dot chay
Beer: bia
Beak: mo chim
Beef: thit bo
Bomb: qua bom
Best: tot nhat
Bear: chiu dung, mang, vac
Boil: soi, luoc
Bury: chon cat, mai tang
Bush: bui ram
Bore: chan
Bone: xuong
Beat: tieng dap, su dap
Boss: ong chu, thu truong
Bend: be cong
Back: tro lai
Belt: that lung
Bake: nung, nuong bang lo
Bill: hoa don
Boat: thuyen
Band: bang, dai, nep
Bite: can
Bank: bo, ngan hang
Bent: khuynh huong
Both: ca hai
Base: co so, co ban, nen mong
Bath: bon tam, su tam
Basic: co ban
Built: xay dung
Bread: banh my
Black: mau den
Board: bang
Brown: mau nau
Brief: ngan gon, tom tat
Brand: nhan, thuong hieu
Brave: gan da, can dam
Began: bat dau
Brain: dau oc, tri nao
Break: be gay, dap vo
Block: ngan chan
Beach: bai bien
Brush: ban chai
Beard: rau
Birth: su ra doi
Build: xay dung
Blind: mu
Begin: bat dau, khoi dau
Blade: luoi guom, ngon co
Burnt: chay
Burst: no, no tung
Buyer: nguoi mua
Bound: nhat dinh, chac chan
Brick: gach
Breed: giong, nuoi
Blame: khien trach
Below: o duoi, duoi thap
Bunch: bo lai
Blood: mau
Broad: rong
Bring: mang
Blank: trong, de trang
Better: tot hon
Budget: ngan sach
Before: truoc day
Became: tro thanh
Border: bien gioi
Beauty: ve dep, cai dep
Borrow: vay, muon
Belong: thuoc quyen so huu
Bridge: cay cau
Behalf: su thay mat
Bitter: dang cay, chua xot
Breast: nguc, vu
Belief: long tin, duc tin
Blonde: vang hoe
Broken: bi gay, bi vo
Butter: bo
Behind: phia sau
Bubble: bong bong, bot
Breath: hoi tho
Battle: tran danh, chien thuat
Bright: sang choi
Branch: chi nhanh
Bottle: chai, lo
Boring: buon chan
Bother: lam phien
Become: tro nen, tro thanh
Button: cai khuy, cuc
Bullet: dan sung
Bottom: phan duoi cung, thap nhat
Beyond: vuot ra ngoai
Behave: doi xu, an o, cu xu
Benefit: loi ich
Brother: anh, em trai
Believe: tin tuong
Biology: sinh vat hoc
Between: giua, khoang cach
Bicycle: xe dap
Billion: ty
Because: boi vi
Bedroom: phong ngu
Balance: can bang
Bargain: su mac ca, su giao keo mua ban
Besides: ngoai ra
Biscuit: banh quy
Banking: tin cay, ngan hang
Brought: mang lai, mang den
Barrier: dat chuong ngai vat
Battery: pin, ac quy
Becoming: tro thanh
Building: xay dung
Baseball: qua bong ro
Business: kinh doanh
Bathroom: phong tam
Backward: ve phia sau, lui lai
Breaking: pha vo
Birthday: sinh nhat
Bacteria: vi khuan
Behavior: hanh vi
Becoming: tro thanh
Beautiful: xinh dep
Breakfast: bua an sang
Billboard: bang quang cao
Boyfriend: ban trai
Beginning: bat dau
Broadcast: phat song
Brilliant: xuat sac
Backstage: hau truong
Briefcase: vat dung ho so
Biological: sinh hoc
Background: ly lich
Basketball: bong ro
Beneficial: co loi
Blackboard: tam bang den
Breathless: het hoi
Bloodstream: dong mau
Backcountry: hau phuong
Businessman: doanh nhan
Blockbuster: bom tan
Beneficence: tinh hay lam phuc
Breadwinner: tru cot gia dinh
Biographical: tieu su
Brightnesses: do sang
Brainwashing: tay nao
Breakthrough: dot pha
Boringnesses: su nham chan
Battleground: chien truong
Bloodthirsty: khat mau
Brinkmanship: nghe nghiep
Businesslike: kinh doanh
Backstretches: duoi lung
Businesswoman: nu doanh nhan
Backcountries: dat nuoc
Bacteriologic: vi khuan hoc
Beneficiation: nguoi thu huong
Brainstormings: dong nao
Bouleversement: dai lo
Bastardization: su khon nan
Bootlessnesses: khong co ung
Barometrically: do khi ap
Blanketflowers: hoa chan
Brotherlinesses: tinh anh em
Bloodlessnesses: khong co mau
Bidirectionally: hai chieu
Businesspersons: doanh nhan
Breathabilities: tho
Blamelessnesses: vo toi va
banana: qua chuoi
ban: cam
bang: vu no
burn: dot
breath: tho
bult: xay
Cry: khoc
Can: co the
Cap: mu luoi trai
Cup: tach, chen
Cat: con meo
Car: xe o to
Cut: cat
Cow: con bo cai
Care: quan tam
Cake: banh ngot
Copy: sao chep
Cook: nau
Coin: dong tien
Cool: mat me
Cost: phi
Clap: vo tay
Cent: dong xu
Chat: noi chuyen
Call: goi
Camp: trai, cam trai
Cold: lanh
Cell: o, ngan
Card: the
Cope: duong dau
Come: den
City: thanh pho
Chew: nhai, ngam nghi
Club: cau lac bo
Chin: cam
Cure: chua tri
Code: mat ma, dieu le
Core: cot loi
Case: truong hop, tinh huong, thuc te
Curb: kiem che
Crop: vu mua
Cast: quang, nem
Curl: xoan
Cash: tien mat
Calm: diem tinh
Chip: vo bao, manh vo
Coal: than da
Chop: chat
Coat: ao choang
Class: lop hoc
Child: dua tre
Close: dong
Could: co the
Clock: dong ho
Cause: nguyen nhan, nguyen do
Candy: keo
Clean: sach se, ro rang
Count: dem, tinh
Cable: day cap
Catch: nam lay, bat lay
Cheap: re
Clear: trong sang, khoang trong
Crown: vuong mien
Crowd: bay dan
Cream: kem
Crash: vu tai nan
Court: toa an
Coach: huan luyen vien
Crazy: dien, mat tri
Cloud: may, dam may
Civil: dan su
Cruel: hung ac
Chest: tu, ruong
Cheat: lua dao
Chart: do thi, bieu do
Chair: ghe
Crush: nguoi minh thich
Cease: ngung, thoi
Crack: nut
Check: kiem tra
Carry: mang
Chief: lanh tu, truong
Craft: thu cong
Crime: toi ac
Climb: leo, treo
Cross: vuot qua
Claim: yeu cau
Curve: duong cong
Chain: chuoi
Court: san nha, cho o
Cloth: vai
Cycle: xe dap
Click: nhap chuot
Cheek: ma
Crisp: gion
Chase: duoi, san bat
Cough: ho
Clerk: thu ki
Cover: che day, bao phu
Coast: bo bien
Chance: co hoi
Create: tao nen
Camera: may anh
Charge: sac dien, phi
Course: khoa hoc
Carrot: cu ca rot
Cancel: huy bo
Cookie: banh quy
Credit: tin dung
Coming: dang den
Cancer: benh ung thu
Capable: co nang luc, co tai
Crisis: cuoc khung hoang
Couple: cap doi
Coffee: ca phe
Cinema: rap chieu phim
Cousin: anh em ho
Custom: tap quan
Circle: khoanh tron
Choose: lua chon
Cheese: pho mat
Castle: thanh tri
Choice: lua chon
Career: nghe nghiep
Colour: mau sac
Carpet: tam tham, tham co
Column: cot
Church: nha tho
Cheque: danh dau
Centre: trung tam
Cannot: khong the
Change: thay doi
Capital: thu do, tu ban
Comedy: hai kich
Cooker: lo, bep nau
Corner: goc
Clever: thong minh
Common: chung
Client: khach hang
Cotton: bong
Commit: giao thac
Closet: buong nho
County: quan hat
Course: mon an, di nhien
Company: cong ty
Central: trung tam
Content: noi dung
Comment: binh luan
Contact: lien lac, lien he
Correct: chinh xac
Control: kiem soat
Captain: nguoi chi huy
Ceiling: tran nha
College: truong dai hoc
Connect: ket noi
Compare: so sanh
Classic: co dien
Certain: chac chan
Concept: khai niem
Concert: buoi hoa nhac
Courage: long can dam
Counter: quay tinh tien
Curtain: buc man
Comfort: an ui
Century: the ky
Curious: to mo
Capture: bat giu
Current: hien hanh
Cottage: nha tranh
Crucial: cot yeu
Careful: can than, can trong
Conduct: chi dao
Combine: ket hop
Customs: phong tuc
Collect: suu tap
Clothes: ao quan
Contest: cuoc thi
Climate: khi hau
Citizen: nguoi thanh thi
Chicken: ga, thit ga
Chemist: nha hoa hoc
Complex: phuc tap
Country: thanh pho, quoc gia
Confine: giam giu
Council: hoi dong
Confirm: xac nhan
Concern: lien quan
Compete: canh tranh
Consult: tham khao
Confuse: lon xon
Culture: van hoa
Command: chi huy
Cabinet: tu co nhieu ngan dung do
Consist: bao gom
Charity: tu thien
Convert: bien doi
Context: van canh
Contain: luu tru
Customer: khach hang
Continue: tiep tuc
Computer: may tinh
Children: tre em
Campaign: chien dich
Complain: phan nan
Chapter: chuong sach
Concrete: be tong
Consumer: nguoi tieu dung
Criminal: toi pham
Chemical: hoa chat
Complete: hoan thanh
Conclude: ket luan
Careless: so xuat, cau tha
Cheerful: vui long
Conflict: cuoc xung dot
Chamber: buong phong
Collapse: sup do
Clothing: quan ao
Convince: thuyet phuc
Cupboard: tu dung chen
Creature: sinh vat
Cultural: thuoc van hoa
Ceremony: nghi le
Category: hang, loai
Contrast: su tuong phan
Contract: hop dong
Chairman: chu tich
Critical: su phe binh
Confront: doi mat
Constant: kien tri, ben long
Congress: hoi nghi
Channel: kenh, eo bien
Capacity: suc chua
Consider: xem xet
Confident: tu tin
Character: tinh cach
Challenge: thu thach
Community: cong dong
Corporate: doan the
Certainly: chac chan
Chocolate: so co la
Committee: uy ban
Candidate: ung cu vien
Celebrate: ky niem
Cardboard: bia cung, cac tong
Container: thung dung hang
Complaint: loi than phien
Colleague: ban dong nghiep
Criterion: tieu chuan
Cigarette: dieu thuoc la
Conscious: biet ro
Criticize: chi trich
Chemistry: mon hoa hoc
Calculate: tinh toan
Condition: tinh trang
Classroom: phong hoc
Criticism: su phe binh
Continent: luc dia
Confusion: su hoang mang
Construct: xay dung
Cellphone: dien thoai di dong
Concerned: lo au
Component: thanh phan
Connected: da ket noi
Completion: hoan thanh
Considered: xem xet
Convenient: thuan tien
Collection: bo suu tap
Commission: uy ban
Continuous: tiep dien
Contribute: dong gop
Confidence: tu tin
Conference: hoi nghi
Connection: su ket noi
Conclusion: phan ket luan
Commercial: thuong mai
Centimetre: don vi xen ti met
Complicate: phuc tap
Cheerfully: vui ve
Concerning: lien quan
Commitment: loi cam ket
Convention: quy uoc
Consistent: thich hop
Controlled: duoc dieu khien
Communicate: giao tiep
Comfortable: su thoai mai
Competition: su canh tranh
Countryside: mien que
Certificate: chung chi
Corporation: su hop tac
Combination: su ket hop
Celebration: le ky niem, su noi tieng
Consequence: hau qua
Contrasting: tuong phan
Consumption: tieu dung
Considering: dang can nhac, xem xet
Countrywide: ngoai o
Concentrate: tap trung
Challenging: thu thach
Constitution: to chuc
Considerable: dang ke
Construction: xay dung
Conversation: cuoc hoi thoai
Contemporary: dong thoi
Circumstance: hoan canh
Continuation: tiep tuc
Contribution: su dong gop
Conventional: thong thuong
Compensation: den bu
Conservative: than trong
Certification: chung nhan
Communication: giao tiep
Contamination: o nhiem
Comprehensive: su nhan thuc
Concentration: nong do
Confrontation: doi dau
Complementary: bo tuc
Consideration: su xem xet
Consolidation: su ben vung, su kien co
Classification: phan loai
Characteristic: dac tinh
Countermeasure: bien phap doi pho
Containerboard: thung chua
Congregational: hoi doan
Constitutional: theo hien phap
Counterbalance: doi trong
Comprehensible: co the hieu duoc
Conservationist: nha bao ton
Contemporaneous: cung thoi
Constructionist: nha xay dung
Capitalizations: viet hoa
Congratulations: chuc mung
Complementarity: su bo sung
confident: tu tin
computer: may tinh
cantin: cang tin
club: cau lac bo
calculate: tinh toan
categor: danh muc
Dog: con cho
Dad: cha, bo
Dot: dau cham
Day: ngay
Dig: dao, boi
Die: chet
Due: qua han
Dry: kho
DVD: dia DVD
Duck: con vit
Date: ngay
Draw: ve tranh
Drug: thuoc
Damp: am uot
Deny: tu choi
Dark: toi
Dish: mon an
Door: cua so
Dear: than men
Desk: ban
Diet: an kieng
Duty: nghia vu
Data: du lieu
Deal: doi pho, giao dich
Dull: cham hieu
Debt: no
Down: xuong
Dare: dam, thach
Dead: chet
Damn: chi trich
Disc: dia
Dirt: chat ban, do ban thiu
Drum: cai trong
Draw: ve
Drag: loi keo
Drop: roi vai
Dump: bai rac
Disk: dia hat
Deaf: diec, lam ngo
Drug: thuoc
Deep: sau
Dream: giac mo
Dance: nhay
Dress: trang phuc
Daily: hang ngay
Depth: do sau
Delay: tri hoan
Devil: ac quy
Doubt: nghi ngo
Death: cai chet
Debut: ra mat
Dozen: ta
Drunk: say ruou
Draft: ban thao
Drive: lai
Dying: su chet
Diary: so nhat ky
Drama: kich
Dirty: ban thiu
Dairy: san pham bo sua
Drill: may khoan
Depot: kho chua
Decay: suy tan, do nat
Danger: nguy hiem
Dinner: bua toi
Desert: sa mac
Depend: phu thuoc
Demand: nhu cau
Dollar: do la My
Dancer: vu cong
Degree: trinh do, bang cap
Decide: quyet dinh
Doctor: bac si
Dragon: con rong
Detect: phat hien
Direct: truc tiep
Detail: chi tiet
Demand: doi hoi, yeu cau
Decent: hop le
Define: dinh nghia
Defeat: danh bai
Derive: nhan duoc
Double: doi, gap doi
Device: thiet bi
Delete: xoa
Decree: nghi dinh
Defend: bao ve, che cho
Desert: hoang mac
Decade: thap ky
Debate: tranh luan
Donate: quyen gop, tang
Divide: chia
Devote: hien dang
Design: thiet ke
Damage: lam hu hai
During: trong thoi gian
Desire: ao uoc
Dust: bui bam
Diamond: kim cuong
Defense: phong thu
Dentist: nha si
Discuss: ban luan
Decided: quyet dinh
Divorce: ly hon
Drawing: suc loi cuon, hap dan
Destroy: pha huy
Deserve: xung dang
Declare: tuyen bo
Diagram: bieu do
Disease: benh
Driving: dieu khien
Defence: phong thu
Despite: bat chap, khinh re
Disturb: quay ray
Decline: suy tan
Depress: chan nan
Delight: niem vui suong
Deposit: dat coc
Dislike: khong thich
Display: trung bay
Deliver: cuu khoi, thoat khoi, bay to, giai bay
Dismiss: sa thai
Disgust: ghe tom
Decision: phan quyet
Domestic: quoc noi
Decrease: giam bot
Division: phan cong
Director: giam doc
Decorate: trang tri
Disaster: tham hoa
December: thang muoi hai
Detailed: chi tiet, bay to
Describe: dien ta
Definite: xac dinh
Discover: kham pha
Dominate: thong tri
District: huyen, mien, khu vuc
Dissolve: tan bien
Delicate: mong manh
Distance: khoang cach
Deserted: hoang vang
Dramatic: kich
Delivery: van chuyen
Document: tai lieu
Divorced: da ly hon
Disagree: bat dong
Disabled: bat luc
Daughter: con gai
Downward: di xuong
Directly: truc tiep
Discount: chiet khau
Directory: danh muc
Different: khac nhau
Defendant: bi cao
Dangerous: nguy hiem
Departure: khoi hanh
Dependent: phu thuoc
Demanding: yeu cau
Designing: thiet ke
Detection: phat hien
Detective: tham tu
Drugstore: hieu thuoc
Direction: phuong huong, chi huy
Determine: quyet tam
Desperate: tuyet vong
Discovery: kham pha
Delighted: vui mung, hai long
Downwards: tro xuong
Disappear: bien mat, khong con
Dishonest: khong trung thuc
Dictionary: tu dien
Department: phong ban
Difficulty: kho khan
Discussion: thao luan
Deficiency: su thieu hut
Decoration: trang tri
Definitely: chac chan
Definition: dinh nghia
Difference: su khac biet
Discipline: ky luat
Determined: xac dinh
Disvantage: dieu bat loi
Depression: phien muon
Decorative: trang tri
Deliberate: co y
Disturbing: phien
Definitive: dut khoat
Downstairs: tang duoi
Distribute: phan phat
Disapprove: khong tan thanh
Definition: dinh nghia
Disappoint: that vong
Description: su mieu ta
Documentary: phim tai lieu
Development: phat trien
Distributor: nha phan phoi
Distinction: phan biet
Demonstrate: chung minh
Destruction: su pha huy
Destination: noi den
Distinctive: khac biet
Declaration: to khai
Disapproval: su phan doi
Distinguish: phan biet, dac biet
Disposition: bo tri
Dishonestly: khong thanh that
Depreciation: khau hao
Distribution: phan phoi
Disciplinary: ky luat
Demographics: nhan khau hoc
Differential: khac biet
Disseminated: pho bien
Disadvantage: bat loi
Deliberately: thong tha
Dramatically: dang ke
Disagreement: bat dong y kien
Displacement: dich chuyen, su doi cho
Dissatisfied: khong hai long
Discriminate: phan biet
Distinguished: phan biet
Decompression: giam bot suc ep
Determination: su quyet tam, su cuong quyet
Documentation: tai lieu
Demonstration: trinh dien, thuyet minh
Dispassionate: khong hai long
Discretionary: tuy y
Disappointing: that vong, khong lam thoa man
Discontinuity: su gian doan
Disadvantaged: thiet thoi
Decomposition: phan huy
Discontinuous: khong lien tuc
Demonstrative: bieu tinh
Differentiate: phan biet
Disinterested: vo tu
Deconstruction: giai cau truc
Discrimination: phan biet doi xu
Disintegration: su tan ra
Disappointment: that vong, nan long
Disinclination: khong ua, chan ghet
Discouragement: chan nan, that vong
Discriminatory: phan biet doi xu, su nhan thuc
Differentiable: co the phan biet, chuc nang phan biet
Deliriousnesses: su say me
Differentiation: su khac biet
Demystification: su pha vo
Dissatisfactory: khong dat yeu cau
Dissatisfaction: khong hai long, khong bang long
Demographically: nhan khau hoc
Departmentalize: phong ban, bo phan hoa
Discontinuation: ngung, gian doan
Disadvantageous: bat loi, lam thiet hai, lam ton that
Desertification: sa mac hoa, ngay han han
Disproportional: khong can xung
Destructivities: su pha huy
diffenrent: khac nhau
done: hoan thanh
double: doi
down: xuong
driver: lai xe
duplicate: dong thoi
delete: xoa
Eat: An uong
Eye: Mat
End: Ket thuc
Each: Moi
Exam: Vi du
Exit: Loi thoat
Easy: De dang
Enjoy: Thich thu
Every: Moi
Eight: So tam
Earth: Trai dat
Early: Som
Eagle: Dai bang
Event: Su kien
Enough: Du
Either: Hoac
Easily: De dang
Effect: Anh huong
Estate: Dong san
Except: Ngoai tru
Expect: Cho doi
Energy: Nang luong
Effort: Co gang
Engine: Dong co
Ensure: Dam bao
Enable: Kich hoat
Entire: Toan bo
Equity: Cong bang
Extent: Muc do
Exhibit: Vat trung bay, trien lam
Explain: Giai thich
Eastern: Phia Dong
Expense: Chi phi
Excited: Bi kich thich
Example: Vi du
Element: Thanh phan
Embassy: Dai su quan
Edition: Su xuat ban, phien ban
Endless: Mai mai
Exactly: Chinh xac
Evident: Hien nhien
Earnings: Thu nhap
Engineer: Ky su
Exercise: Luyen tap, thuc hanh
Exchange: Trao doi
Economic: Kinh te
Evidence: Chung co
Estimate: Uoc tinh, luong gia
Everyday: Moi ngay
Exposure: Su phoi nhiem, su gian xao
Enormous: To lon, khong lo
Evaluate: Gia tri
Emergency: Truong hop khan cap
Executive: Dieu hanh
Extensive: Sau rong, hieu biet rong
Education: Giao duc
Expertise: Chuyen mon
Explosion: Vu no
Establish: Thanh lap
Emotional: Da cam
Excellent: Xuat sac
Existence: Su ton tai
Evolution: Su phat trien
Economics: Kinh te hoc
Expansion: Su banh truong
Exception: Ngoai le
Efficient: Co hieu qua
Excessive: Qua dang
Everybody: Moi nguoi
Exclusion: Loai tru
Effective: Co hieu luc
Especially: Dac biet
Employment: Noi lam viec, cong viec
Everywhere: Khap noi
Everything: Moi thu
Enterprise: Doanh nghiep
Excellence: Xuat sac
Exhibition: Buoi trien lam
Expression: Bieu hien, cach bieu lo
Enrollment: Ghi danh
Experiment: Thi nghiem
Enthusiasm: Hang hai
Excitement: Su phan khich
Eventually: Cuoi cung, sau cung
Engagement: Hon uoc, le dinh hon
Engineering: Ky thuat
Educational: Phuong phap giao duc
Experienced: Kinh nghiem
Encouraging: Khich le, khuyen khich
Effectively: Hieu qua
Environment: Moi truong
Exploration: Su kham pha, tham do
Exclamatory: Cam than, than tu
Examination: Kiem tra
Endorsement: Chung thuc
Explanatory: Giai thich
Egalitarian: Binh dang
Emotionless: Vo cam
Expectation: Su mong doib
Emplacement: Su thay the
Excrescence: Su xuat hien
Exponential: So mu
Encroachment: Su lan chiem
Exploitation: Khai thac, su loi dung
Experiential: Dua theo kinh nghiem
Enthusiastic: Tan tam
Excruciating: Dau don, du doi
Equivocation: Khong ro rang
Econometrics: Kinh te luong
Electrolytic: Dien phan
Emotionalism: Cam dong
Electrolysis: Dien phan, dien tu
Expressivity: Bieu cam
Exterminator: Ke am sat
Establishment: Thanh lap
Extraordinary: La lung, phi thuong
Environmental: Thuoc ve moi truong
Embarrassment: Su lung tung
Expressionism: Bieu thi
Extragalactic: Ngoai thien ha
Expeditionary: Vien chinh
Electrostatic: Tinh dien
Entertainment: Moi truong
Encouragement: Su khuyen khich
Enlightenment: Lam ro rang, giac ngo
Extracellular: Khac thuong
Ethnocentrism: Chu nghia dan toc
Endocrinology: Khoa noi tiet
Equilibration: Thang bang
Equilibristic: Can bang
Electroforming: Dien hoa
Electronically: Dien tu
Ecclesiologist: Nha giao hoi hoc
Electivenesses: Quyen lua chon
Ecocatastrophe: Tham hoa
Electrofishing: Danh bong dien
Emotionalizing: Tao cam xuc
Emotionalistic: Tinh cam
Electabilities: Dien nang
Embarrassments: Su boi roi, lung tung
Effectivenesses: Hieu qua
Electrodynamics: Dong dien hoc
Excommunication: Sa thai, su khai tru
Electromagnetic: Dien tu
Extracurricular: Ngoai khoa
Exemplification: Su ton vinh
Ethnomusicology: Dan toc hoc
Electrodeposits: Do dien tu
Educationalists: Cac nha giao duc hoc
Electrochemical: Dien hoa
Expensivenesses: Su dat tien
english: tieng anh
entertainment: giai tri
environment: moi truong
enter: vao
esport: tro choi dien tu
Fun: thu vi
Fee: phi
Fat: beo
Fit: phu hop
Fly: bay
Fox: con cao
Flu: benh cum
For: cho, vi
Fix: sua chua
Far: xa
Fry: chien, ran
Fur: long thu
Fan: nguoi ham mo
Few: vai
Fee: hoc phi, thu lao
Food: thuc an
Four: so bon
From: tu
Face: mat
Fast: nhanh
Film: phim
Fish: con ca
Farm: trang trai
Flag: quoc ky
Fair: cong bang
Full: day
Feed: cho an, nuoi
Feel: cam thay
Fear: lo so
Flat: bang phang
Fame: danh tieng
Fill: lap day
Fork: cai nia
Flow: su chay, chay
Free: mien phi
Find: tim
Fail: that bai
Fuel: nhien lieu
Fire: lua, dot chay
Foot: ban chan
Fund: quy, tien von
Form: hinh thuc, hinh the
Fine: tot
File: tap tin
Firm: chac chan
Fall: roi, nga
Fact: truong hop, thuc te
Fold: gap lai
Fruit: trai cay
Field: cach dong
Fresh: tuoi
First: thu nhat, dau tien
Floor: san nha
Fight: danh nhau
Found: tim ra
Fully: day du
Fence: hang rao
Float: troi noi
Fixed: co dinh
Fetch: tim ve, dan den
Fever: con sot
Flour: bot mi
Faint: mo nhat, yeu
Front: truoc mat
False: sai lam, gia doi
Flame: ngon lua
Flesh: thit
Frame: khung, cau truc
Funny: buon cuoi
Final: cuoi cung
Flood: lu lut
Fault: loi, sai sot
Force: luc luong
Faith: su tin tuong
Focus: tieu diem, tap trung
Flash: loe sang, vut sang
Fancy: tuong tuong, men
Friend: ban
Friday: thu sau
Famous: noi tieng
Faucet: voi nuoc
Father: bo
Finger: ngon tay
Female: giong cai, phu nu
Future: tuong lai
Factor: nhan to
Follow: theo doi
Forest: rung
Frozen: lanh gia
Fasten: dong lai, buoc
Figure: nhan vat
Favour: ung ho
Flying: bay, chuyen bay
Family: gia dinh
Fellow: dong chi
Freeze: dong lanh
Forget: quen
Flight: chuyen bay
Formal: chinh thuc
Finely: dep de, te nhi
Flower: bong hoa
Former: luc truoc
Firm: kien quyet
Fridge: tu lanh
Farmer: nong dan
Freely: tu do, thoai mai
Fairly: khong thien vi
Finish: ket thuc
Finance: tai chinh
Freedom: tu do
Foreign: ngoai quoc
Further: them nua
Feather: long vu
Feeling: cam giac
Forgive: tha thu
Feature: dac tinh
Fashion: thoi trang
Flavour: huong vi
Funeral: tang le
Factory: nha may
Forward: hien nhien, o dang truoc
Fishing: cau ca
Finally: sau cung
Federal: lien bang
Founder: nguoi sang lap
Folding: gap lai duoc
Failure: that bai
Forever: mai mai
Farming: nong nghiep
Finding: phat hien
Formula: cong thuc
Freshly: tuoi
Faintly: nhut nhat, yeu ot
Ference: su khac biet
Fortune: van may
Feedback: phan hoi
Firewall: tuong lua
Festival: le hoi
Function: chuc nang
Football: bong da
February: thang hai
Familiar: quen biet
Facility: co so
Forecast: du bao
Faithful: trung thanh
Fighting: tran danh
Finished: hoan thanh
Formerly: truoc kia
Frequent: thuong xuyen
Frighten: hoang so
Formally: chinh thuc
Floating: noi, noi tren mat nuoc
Furthest: xa nhat
Fraction: phan so
Friendly: than thien
Freelance: nghe tu do
Financial: tai chinh
Forgotten: bi lang quen
Following: theo doi
Furniture: do dac
Framework: khuon kho
Frequency: tan so
Fortunate: may man
Favourite: yeu thich
Formation: su hinh thanh
Franchise: chuoi
Fellowship: tinh bang huu
Formidable: ghe gom, du doi
Friendship: tinh ban
Foundation: nen tang, thiet lap
Functional: chuc nang
Federation: lien ket
Frightened: so set
Frequently: thuong xuyen
Faithfully: trung thanh
Facilitate: tao dieu kien
Fingerprint: van tay
Fundamental: co ban
Fascination: me hoac
Fundraising: gay quy
Forgiveness: su tha thu
Furthermore: hon nua
Fashionable: hop thoi trang
Forthcoming: sap toi, sap den
Fascinating: hap dan, quyen ru
Frightening: khung khiep
Familiarity: quen thuoc, tinh than mat
Frustration: that vong, phan khang
Fountainhead: nguon goc
Fenestration: su tong hop
Facilitation: tao dieu kien, de dang
Fibrillation: rung tim
Flamethrower: sung phun lua
Freestanding: ha canh tu do
Frontiersman: bien phong
Fluorescence: tinh huynh quang
Foreknowledge: tien tri
Functionality: chuc nang
Fragmentation: phan manh, manh vo
Fortification: vung chac, su cung co
Ferroelectric: chat sat dien
Fructification: ket trai
Frictionlessly: khong ma sat
Fundamentalism: chu nghia co ban
Friendlinesses: than thien
Ferromagnesian: sat tu
Fundamentalist: nguoi theo chu nghia chinh thong
Featherstitched: long vu
Faithlessnesses: nhung nguoi khong trung thanh
Ferociousnesses: hung du
Fingerprintings: dau van tay
Fashionableness: hop thoi trang
Featherbeddings: chan long vu
Federalizations: lien bang
Favorablenesses: nhung dieu thuan loi
Familiarization: lam quen, thoi quen
Fanaticalnesses: su cuong tin
Fantastications: nhung dieu ki dieu
Follow:theo duoi
Go: di
Gas: khi, hoi dot
Gun: sung
Guy: anh chang
God: chua
Gap: cho trong
Get: duoc, co duoc
Game: tro choi
Gold: vang
Good: tot
Give: tang, dua
Gate: cong
Goal: muc tieu, ban thang
Girl: co gai
Gain: thu duoc
Gift: qua tang
Glue: keo dinh
Glad: vui suong
Gene: gia he
Grey: xam
Grow: lon len
Gram: dau xanh
Gear: hop so
Grab: vo lay
Gray: mau xam
Grid: luoi
Grape: nho
Green: mau xanh
Group: nhom
Guest: khach moi
Guide: huong dan
Grown: tang
Giant: nguoi khong lo
Great: tuyet
Grand: vi dai, rong lon
Grade: cap
Glove: gang tay
Grave: mo, nghiem trang
Grass: co
Guess: phong doan
Grant: khoan tro cap
Guard: bao ve
Goods: cua cai, mat hang
Grain: ngu coc
Glass: thuy tinh
Global: toan cau
Garden: vuon
Genius: thien tai
Gender: gioi tinh
Growth: su phat trien
Golden: vang
Gentle: diu dang
Ground: dat
Gamble: danh bac
Govern: quan ly, thong tri
Garage: nha de o to
Gently: diu dang
Guilty: toi loi
Gentle: diu dang
Gather: tu hop
Gallon: Galong 1gl = 4, 54 lit o Anh, 3, 78 lit o My
Graphic: do hoa
General: chung, tong
Gravity: trong luc
Genetic: di truyen
Grammar: ngu phap
Gallery: bo suu tap
Genuine: chinh hang
Garment: quan ao
Grocery: tap hoa
Gradual: dan dan
Gateway: cong vao
Glasses: kinh deo
Greater: lon hon
Garbage: do long, rac
Goodbye: tam biet
Governor: thong doc
Generous: hao phong
Guidance: huong dan
Geometry: hinh hoc
Guardian: nguoi giam ho
Gasoline: xang
Grandson: chau trai
Generate: tao ra
Graphics: do hoa
Greeting: loi chao
Grateful: tri an
Grouping: phan nhom
Genomics: bo gen
Goodwill: thien chi
Gambling: bai bac
Goodness: nhan hau
Gentleman: quy ong, quy phai
Geography: mon dia ly
Generally: noi chung la
Guerrilla: du kich
Guarantee: bao hanh
Generally: noi chung
Goldsmith: tho kim hoan
Geometric: hinh hoc
Genuinely: chan that
Generator: may phat dien
Glamorous: hao nhoang
Groceries: hang tap hoa
Gradually: dan dan
Gathering: thu nhap
Gratitude: long biet on
Graduation: tot nghiep
Generation: the he
Greenfield: canh dong xanh
Government: chinh phu
Girlfriend: ban gai
Geographic: dia ly
Generosity: hao phong, rong luong
Generously: hao phong
Groundwork: co so
Grandchild: chau cua ong ba
Goalkeeper: thu mon
Gynecology: phu khoa
Gastronomic: kinh te hoc
Grandfather: ong noi/ong ngoai
Grandmother: ba noi/ba ngoai
Gingerbread: banh gung
Generalized: tong quat
Grammatical: ngu phap
Grandparent: ong ba
Gravimetric: trong luc, trong luong
Gallbladder: tui mat
Goaltending: lam muc tieu, san ban
Gerontology: nganh nghien cuu tuoi gia
Governorship: quyen thong doc
Geochemistry: dia hoa hoc
Gastrulation: dau bung
Geriatrician: bac si nhi khoa
Groundbreaker: tau ngam
Groundskeeper: nguoi trong coi
Geochronology: dia ly hoc
Granddaughter: chau gai
Gubernatorial: thong doc
Gratification: su hai long, su vua y
Geomorphology: dia mao
Gastrocnemius: da day
Generalization: su khai quat
Groundbreaking: dong tho
Geosynchronous: khong dong bo dia ly
Gravitationally: hap dan
Governmentalism: chu nghia chinh quyen
Gastroenteritis: viem da day ruot
Geochronologies: dia ly
Garrulousnesses: su tuyet voi
Gastronomically: noi ve mat kinh te hoc
in: trong
it: no, cai do, con vat do
if: neu nhu
ice: bang, nuoc da
ill: om, dau
ink: muc
its: cua cai do, cua dieu do, cua con vat do
icon: bieu tuong
idea: y tuong
iron: sat
item: muc
into: vao trong
inch: don vi do chieu dai anh bang 2, 54 cm
image: hinh anh
index: muc luc
input: dau vao
issue: van de
ideal: ly tuong
irony: tro treu
imply: bao ham, ngu y
idiom: cach dien dat
inter: hap dan
inner: ben trong
island: dao
indoor: o trong nha
invite: moi
import: nhap khau
invent: phat minh
invest: dau tu
income: thu nhap
inside: phia trong
intend: y dinh, du dinh
insect: con trung
infect: lay nhiem
impose: ap dat, bat buoc
insert: chen vao, xen vao
indeed: that
injury: thuong tat
insult: su xi nhuc
inform: bao, to cao
insist: nan ni
impact: su va cham
ignore: lam lo
itself: chinh cai do, chinh dieu do, chinh con vat do
injure: bi thuong, lam hai
improve: tien bo, cai thien
include: bao gom
instant: tuc thi
instead: thay vi
insight: sang suot
imagine: tuong tuong
ideally: ly tuong
injured: bi ton thuong
immoral: trai voi dao duc
install: dat, tai ve
illegal: khong hop le
involve: lien quan
impress: gay an tuong
illness: benh tat
initial: ban dau
intense: manh liet
instance: phien ban
increase: tang
interior: noi dia
indirect: gian tiep
internal: noi bo
included: bao gom
intended: du dinh
indicate: noi bo
internet: mang
involved: bi lien luy
informed: thong bao
informal: khong trang trong
irritate: choc tuc, kich thich
identify: nhan dinh
infected: bi nhiem
industry: nganh cong nghiep
interval: khoang thoi gian
interest: su thich thu, loi lai
innocent: vo toi
incident: su co, co the xay ra
interview: phong van
institute: hoc vien
important: quan trong
introduce: gioi thieu
infection: nhiem trung
inventory: hang ton kho
insurance: bao hiem
inflation: lam phat
illegally: bat hop phap
impression: an tuong, in dau
interpret: giai thich
influence: anh huong
intention: chu y
implement: trien khai thuc hien
inevitably: tat yeu
impressed: an tuong
imaginary: tuong tuong
insulting: xuc pham
immediate: ngay tuc khac
invention: su phat minh
irritated: tuc gian, cau tiet
including: bao gom
inability: su bat tai
initially: ban dau
interrupt: ngat, lam gian doan
interface: giao dien
impatient: thieu kien nhan, nong voi
ingredient: nguyen lieu
industrial: cong nghiep
impossible: khong the nao
investment: su dau tu
instrument: dung cu
initiative: sang kien
illustrate: minh hoa
impressive: an tuong
importance: tam quan trong
individual: ca nhan
inevitable: khong the tranh khoi
invitation: loi moi
interested: thu vi
innovative: sang tao
infectious: lay nhiem
indirectly: gian tiep
irritating: lam phat cau
indication: su chi dan
innovation: su doi moi
investigate: dieu tra
intelligent: thong minh
information: thong tin
implication: ham y
interesting: thu vi
institution: to chuc
instruction: chi dan
independent: doc lap
impatiently: sot ruot
incorporate: ket hop
improvement: su tien bo
immediately: tuc thi
interaction: su tuong tac
involvement: su tham gia
imagination: tri tuong tuong
integration: hoi nhap
importantly: quan trong
interactive: tuong tac
interference: giao thoa
illustration: hinh minh hoa
introduction: gioi thieu
instrumental: nhac cu
intellectual: tri thuc
introductory: gioi thieu
interruption: su gian doan
inflammatory: gay viem
independence: su doc lap
intelligence: su thong minh
insufficient: khong du
installation: cai dat
increasingly: tang them
inconsistent: khong nhat quan
intermediate: trung gian
incorporated: ket hop
investigative: dieu tra
institutional: the che
insignificant: tam thuong
indispensable: can thiet
international: quoc te
incorporating: ket hop
investigation: cuoc dieu tra
instantaneous: tuc thi
irresponsible: vo trach nhiem
independently: doc lap
interpersonal: giua cac ca nhan
inconvenience: bat loi, khong thuan tien
inappropriate: khong thich hop
identification: nhan biet
indestructible: khong the pha huy
infrastructure: co so ha tang
impressionable: khong the an tuong
irreconcilable: khong the hoa giai
interpretation: dien dich
insignificance: khong dang ke
insurmountable: khong the vuot qua
intelligentsia: nguoi thong minh, nguoi khon ngoan
interpretative: phien dich
indiscriminate: bua bai
inconsiderable: khong the coi thuong
interdependent: lien ket voi nhau, phu thuoc vao nhau
interplanetary: lien hanh tinh
instrumentality: cong cu
impressionistic: nghe si an tuong
intellectualism: chu nghia tri tue
instrumentation: thiet bi do dac
indemnification: su boi thuong
interchangeable: co the hoan doi cho nhau
instrumentalist: nhac cu, nhac cong
intercollegiate: lien truong
incomprehension: su hieu biet
incompatibility: khong tuong thich
inconsequential: khong dang ke
interscholastic: xen ke
hi: xin chao
he: anh ay
hat: cai mu
had: co
hot: nong
her: cua co ay
him: anh ta
how: the nao
hip: hong
his: cua anh ay
hit: danh
hand: ban tay
hear: nghe
hate: ghet
heal: chua tri
hope: hi vong
help: giup do
have: co
host: chu nha, dan chuong trinh
home: nha
hunt: di san
hero: anh hung
hide: an giau
hair: toc
hell: dia nguc
hall: dai sanh
head: cai dau
horn: sung
heat: nhiet, suc nong
hill: doi
hard: kho khan
half: mot nua
hire: thue
hole: lo, ho
heel: got chan
harm: ton hai
high: cao
hour: gio
hers: cua co ay
hold: cam, nam
holy: thanh thien, sung bai
hurt: bi dau
hook: cai moc
hail: keu
huge: khong lo
hang: treo
here: o day, tai day
heart: trai tim
human: nhan loai
happy: vui ve
house: ngoi nha
hello: xin chao
hotel: nha nghi
hence: vi the
hurry: voi
habit: thoi quen
heavy: nang
horse: con ngua
hungry: doi bung
health: suc khoe
handle: xu ly
hammer: bua
humour: hai huoc
horror: kinh di, ghe ron
happen: xay ra
honest: trung thuc
hollow: rong
heaven: thien duong
highly: cao
hobby: so thich
hatred: su thu ghet
honour: kinh trong
height: chieu cao
hardly: kho khan
holiday: ky nghi
history: lich su
husband: chong
himself: ban than anh ay
healthy: khoe manh, lanh manh
holding: giu, chiem huu
hundred: tram
helping: giup do
hearing: thinh giac
heating: suoi, lam nong
heavily: nang ne
helpful: huu ich, giup do
hunting: san ban
happily: hanh phuc
highway: duong quoc lo
housing: nha o
harmful: co hai
herself: ban than co ay
however: tuy nhien, the nhung
highland: cao nguyen
hospital: benh vien
heritage: gia tai
homeless: vo gia cu
handling: su dieu khien
hesitate: do du
hardware: phan cung
harmless: khong co hai
honestly: thanh that
headache: dau dau
homework: bai tap ve nha, cong viec nha
humorous: hai huoc
humanity: nhan loai
horrible: kinh khung, ghe gom, khiep so
historic: lich su
highlight: diem noi bat
household: ho gia dinh
historian: nha su thi
honeymoon: tuan trang mat
hierarchy: he thong cap bac
happening: dang xay ra, bien co, tai hoa
honorable: danh gia
hostility: thu dich
happiness: niem hanh phuc
hopefully: hi vong
hurricane: bao
helicopter: may bay truc thang
harmonious: hai hoa
historical: lich su
homosexual: dong tinh luyen ai
hysterical: loan tri
honourable: danh gia, ve vang
horizontal: ngang, nam ngang
hesitation: do du
hemisphere: ban cau
hematology: huyet hoc
hypothesis: su gia thuyet
housekeeper: nguoi quan gia
hairdresser: tho cat toc
handwriting: chu viet tay
hospitality: long hieu khach
heavyweight: hang nang
homogeneous: dong nhat
handicapped: tat nguyen, bat loi
humiliation: su si nhuc
handkerchief: khan tay
humanitarian: nhan dao
hypertensive: tang huyet ap
headquarters: tru so chinh
hypothetical: gia thuyet
heartbreaker: nguoi lam tan nat trai tim
hypertension: tang huyet ap
housekeeping: don phong
heartbreaking: dau long
hydroelectric: thuy dien
heterogeneous: khong dong nhat
hundredweight: tram can
homosexuality: dong tinh luyen ai
hallucination: ao giac
housecleaning: don nha
hypoallergenic: khong gay di ung
historiography: lich su hoc
headquartering: tru so chinh
histochemistry: hoa hoc
hypersensitive: qua man cam
habitabilities: thoi quen
hyperconscious: sieu y thuc
humanitarianism: chu nghia nhan dao
hypermobilities: sieu linh hoat
hospitalization: nhap vien
hyperactivities: tang dong
historiographer: nha su hoc, su ky
joy: vui suong
jam: mut
job: nghe nghiep
jar: cai lo
jaw: ham
jump: nhay
july: thang bay
june: thang sau
just: chi, vua moi
join: tham gia
joke: tro cuoi, loi noi dua
jack: giac cam
judge: tham phan
juice: nuoc ep
joint: chung, khop
jeans: quan bo, quan jean
jakes: tro dua
jelly: thach
jolly: vui ve
jacket: ao khoac
junior: tre em
jungle: rung nhiet doi, mo hon don
january: thang gieng
journey: hanh trinh
journal: tap chi
justify: bao chua, bien ho
justice: su cong bang
jubilee: le ky niem
jealous: ghen tuong
juniper: cay bach xu
jointly: chung, cung nhau
juncture: thoi co
junction: giao lo, cho gap nhau
jalapeno: ot
jubilant: ham hoan, mung ro
joystick: can dieu khien
jeopardy: nguy co, canh hiem ngheo
jaundice: benh vang da, su ghen tuc
jellyfish: con sua
jewellery: do kim hoan
juridical: phap ly
judiciary: co quan tu phap
judicious: khon ngoan
juxtapose: de canh nhau
justified: chinh dang
jailhouse: nha tu
journalism: bao chi
journalist: nha bao, ky gia
judgements: ban an, su xet xu
jeopardize: huy hoai, lieu mang
journeyman: nguoi hanh trinh
judgmental: phan xet
journalizes: viet nhat ky
justifiable: co the bien minh duoc
journeywork: hanh trinh
justiciable: bi thuoc quyen xet xu
jactitation: pho truong
juvenilities: vi thanh nien
journalistic: bao chi
judicatories: giam khao
joyfulnesses: niem vui
juvenescence: thoi ky thanh thieu nien
justificative: de bao chua, de bien ho
justification: su bien ho
justificatory: bien minh
jurisprudence: khoa luat phap, luat hoc
justifiability: tinh hop ly, tinh chat hop ly
justifications: bien minh
jollifications: dieu kien
justiciability: tinh tham dinh
jurisprudential: luat hoc
judiciousnesses: su phan xet
kid: dua tre
key: chia khoa
king: vua
kiss: nu hon
keep: giu, nam
keen: sac sao
kind: tot bung, tu te
knit: dan, theu
kill: giet, tieu diet
knot: that nut
know: biet
knee: dau goi
kick: da, cu da
knife: con dao
kitty: meo con, meo nho
karma: nghiep
known: da biet, nhan ra
knock: go cua, dung cham, dung phai
knack: kheo leo, su kheo tay
keeper: nguoi bao quan, thu mon
kidnap: bat coc, bat giu
keypad: ban phim
killed: lam nga, bi giet
kindly: vui long, long nghia hiep, co long tot
knight: hiep sy, nguoi di lang thang
knives: con dao, dao gam
kiddie: dua tre
kettle: am dun nuoc, viec rac roi
kitchen: bep
kingdom: vuong quoc
keyword: tu khoa
keeping: duy tri
keynote: diem chu yeu, bai phat bieu chinh thuc
killing: giet, sat trung
kickoff: bat dau
ketchup: sot ca chua
knitted: duoc dan, duoc theu
kindred: giong nhau, tuong tro
knowing: biet, thong minh, trang nha
kangaroo: con chuot tui
knitwearh: hang det kim
keyboard: ban phim
kindness: long tot, tu te
knockout: ha guc
keepsake: vat ky niem
kindling: kich thich
kilogram: khoi luong ki lo gam
kingship: vuong quyen, vuong vi
knickers: quan dui
knitting: su dinh lien, su ket hop
kinetics: dong hoc
kerosene: dau hoa
knowledge: hieu biet, hoc thuc
keystroke: to hop phim
kingcraft: vua lua dao
knock-down: gia thap nhat, co the thao ra duoc
kickboard: van truot chan
kilometre: ki lo met
keratitis: viem giac mac
knighthood: hiep si, giai cap
kingfisher: boi ca, chim boi ca
kinematics: dong hoc
knickknack: do dac, ban ghe
kickboxing: kick-boxing
kitchenette: bep nho
kitchenware: do bep, dung cu lam bep
knucklehead: dot ngon tay
kleptomania: tat an cap
kindhearted: tot bung
kindergarten: mau giao
kaleidoscopes: kinh van hoa
kinematically: dong hoc
knowledgeable: co kien thuc, thong minh, hieu ro
knightlinesses: hiep si
knickerbockers: do dan lat
kremlinologists: cac nha nghien cuu ve dien
kindergarteners: truong mau giao, tre mau giao
kindheartedness: long tot
lie: noi doi
law: luat su
lip: moi
leg: chan
lay: xep, dat, bo tri
let: cho phep
lot: nhieu
lab: phong thi nghiem
low: thap, be
lid: nap, vung
love: tinh yeu
lamp: den
last: cuoi cung
lock: khoa
like: thich, giong nhu
long: dai
lady: quy ba
loud: to tieng
leaf: la cay
lord: chua te
look: nhin
list: danh sach
life: doi song
lane: lan duong
lazy: luoi bieng
live: truc tiep, cuoc song
lake: ho
late: muon
load: trong tai
lend: cho muon
lead: chi huy
lost: thua, mat
left: ben trai
luck: may man
loss: su thua, su mat
lung: phoi
line: day, duong, tuyen
less: it hon
lack: thieu
lean: nghieng, dua, y vao
link: lien ket
lose: mat, thua
lump: cuc buou
lift: nhac len
land: dat dai
loan: khoan vay, tien vay muon
lucky: may man
local: dia phuong, ban dia
light: anh sang
level: trinh do, cap bac
learn: hoc tap
lunch: bua trua
laugh: cuoi, cuoi ro len
large: lon, rong rai
lemon: qua chanh
litre: lit
lobby: phong cho, sanh doi
lover: nguoi yeu
loose: long
limit: gioi han
lease: cho thue
lower: thap hon, giam bot
layer: lop
loyal: trung thanh
least: it nhat, nho nhat
lorry: xe tai
later: sau do
leave: roi di
label: nhan, mac
links: lien ket
liver: gan
legal: hop phap, thuoc ve phap luat
leader: thu linh, nguoi chi huy
listen: nghe
letter: chu cai
league: lien doan, lien minh
lawyer: luat su
lovely: dang yeu
length: chieu dai
labour: nhan cong, lao dong
little: it
linked: da lien ket
lonely: co don
lesson: bai hoc
liquid: chat long, em ai
losing: thua, that lac
launch: ra mat
lively: song dong
logic: hop ly
likely: co kha nang, co le that
locate: dinh vi
latest: muon nhat
living: cuoc song
loudly: am i, inh oi
latter: sau nay, chi vat sau cung
library: thu vien
loyalty: long trung thanh
lecture: bai hoc, cuoc dien thuyet
lengthy: dai dong
leading: su chi huy, dan dau
licence: giay phep
leisure: ranh roi, giai tri
limited: gioi han
logical: hop ly
listing: su lang nghe, danh sach
landing: do bo, len bo
leather: da
located: dinh vi
leasing: cho thue, giao ket
lacking: thieu xot
loosely: long leo
lightlly: nhe nhang
license: giay phep, su cho phep
legally: hop phap
locally: dia phuong
largely: phan lon
luggage: hanh ly
lasting: ben vung, su truong cuu
location: vi tri
language: ngon ngu
landmark: phong canh
lecturer: nguoi giang day, giang vien
leverage: tan dung
learning: hoc tap
laughter: tieng cuoi, cuoi am len
lighting: thap sang
literary: van hoc
lifetime: ca doi
likewise: tuong tu, hon nua
limiting: han che, gioi han
literacy: trinh do hoc van
luncheon: bua an trua, tiec trua
landlord: chu nha, chu quan
legendary: huyen thoai
lifestyle: cach song
luxurious: sang trong
liability: trach nhiem phap ly
limestone: da voi
liquidity: tinh trong suot
localized: cham chan tai cho, ban dia
landscape: phong canh
lightning: tia chop
literally: theo nghia den
lucrative: sinh loi
ludicrous: lo bich
leasehold: nha cho muon, cho thue
lunchtime: gio an trua
logistics: hau can, theo doi hau can, cong ty hau can
leadership: kha nang lanh dao
lighthouse: ngon hai dang
lymphocyte: te bao
locomotion: su chuyen dong, su van dong
legitimize: hop phap hoa
landlocked: o giua dat lien
literature: van chuong
liberalism: chu nghia tu do
laboratory: phong thi nghiem
liberalize: tu do hoa
likelihood: kha nang xay ra
linerboard: tam lot
legitimate: hop phap, dich ton
liberation: su tu do, phong thich
locomotive: di du lich
lieutenant: trung uy
letterhead: bia thu
lamentable: than tho, dang thuong, toi nghiep
linguistic: ngon ngu, thuoc ve ngon ngu hoc
limitation: su han che, gioi han
legislature: co quan lap phap
lightweight: nhe can
legislation: phap luat, su lap luan
linguistics: ngon ngu hoc
loudspeaker: may phat thanh, loa ngoai
legislative: lap phap, quyen lap phap
libertarian: nguoi theo chu nghia tu do
labyrinthine: me cung
luminescence: phat quang
listenership: thinh gia
longitudinal: theo chieu doc
lexicography: tu dien hoc
laryngoscope: soi thanh quan
longshoreman: nguoi lam o hai cang
liquefaction: hoa long
lighthearted: nhe da ca tin
lucrativeness: kha nang sinh loi
lymphadenitis: viem hach
laughingstock: tro cuoi
lymphocytosis: tang bach cau
lexicographer: nha nghien cuu tu vung hoc
lackadaisical: thieu kinh nghiem
logicalnesses: tinh logic
lignifications: giai nghia
legitimatizing: hop phap hoa
lateralization: qua trinh hoa da
landlessnesses: khong co dat
lasciviousness: su deo dai
lifelikenesses: song dong nhu that
liberalization: tu do hoa
lithologically: ve mat ngu van
latitudinarian: nguoi latinh
legitimizations: luat phap
laboriousnesses: su can cu
longsightedness: can thi nang
lymphadenopathy: noi hach
lucrativenesses: sinh loi
lymphadenitises: hach
logographically: ve mat logic
ludicrousnesses: su lo lang
now: bay gio
net: luoi, mang
not: khong
nut: qua hach: dau
new: moi
neck: co
need: can
nose: mui
note: loi ghi, loi ghi chep: ghi chu, ghi chep
nail: mong tay
nice: dep, thu vi, de chiu
next: tiep theo
news: tin, tin tuc
nest: to, o: lam to
name: ten
neat: sach, ngan nap: ranh mach
near: gan, can: o gan
navy: hai quan
needs: can
niece: chau gai
naked: tran, khoa than, tro trui
nerve: khi luc, than kinh, can dam
newly: moi
nurse: y ta
never: khong bao gio
night: dem, toi
north: huong bac
noise: tieng on, su huyen nao
noisy: on ao, huyen nao
noway: khong doi nao
novel: tieu thuyet, truyen
nurse: y ta
nearly: gan, giong lam, giong het
nation: dan toc, quoc gia
notice: chu y
newbie: thanh vien
nobody: khong ai ca
nearby: lan can
number: so
napkin: khan an
noodle: bun
notice: thong bao, yet thi: chu y, de y, nhan biet
normal: binh thuong
needle: cai kim, mui nhon
neatly: gon gang, ngan nap
nephew: chau trai
nature: tu nhien, thien nhien
narrow: hep
naughty: nghich ngom
network: mang luoi
nuclear: nguyen tu
nowhere: khong noi nao, khong o dau
neither: cung khong
natural: tu nhien
nervous: lo lang
nothing: khong co gi
northern: phuong bac
nowadays: ngay nay
notebook: so ghi chep
neckwear: khan choang co
negligee: nguoi da den
novation: nang cao
necessary: can thiet
neighbour: nguoi lang gieng, hang xom
naturally: mot cach tu nhien
negotiate: dam phan
northeast: dong bac
nutrition: dinh duong
narrative: tuong thuat
nightmare: ac mong
nightlife: cuoc song ve dem
numerical: thuoc ve so
normative: quy pham, gia tri
newspaper: bao
necessity: su can thiet
nightfall: dem xuong, luc mat troi lan
negligible: co the bo qua, khong dang ke
newsletter: bang tin
nationwide: the gioi chung, toan quoc
navigation: dan duong
negligence: thieu trach nhiem
neglectful: khong chu y, bo be, bo quen
noticeable: dang chu y, thay ro rang
nomination: su de cu, su binh chon
nightshade: cay bach anh, cay mong toi
necessitate: can thiet, bat buoc
negotiation: su giao dich
necessarily: nhat thiet
nationality: quoc tich
neutralizer: chat trung hoa
newsreaders: nguoi doc tin tuc
neutralized: vo hieu hoa
neglectfully: lo denh
nevertheless: tuy nhien
neighborhood: khu vuc lan can
notification: thong bao
negotiations: dam phan, su doi chac
naturalistic: tu nhien
nephropathic: suy than
nondeductible: khong duoc khau tru
nonreflecting: khong phan anh
nonconformity: khong phu hop
nonproductive: khong hieu qua, khong san xuat
nonnegotiable: khong the thuong luong
noncompliance: khong tuan thu, khong bang long
nonconformist: nguoi khong tuan thu
nondistinctive: khong phan biet
nondestructive: khong pha huy
nanotechnology: cong nghe nano
noncoopertion: khong hop tac
nonprescription: khong theo don
nearsightedness: can thi
nonprofessional: khong chuyen nghiep
neutralizations: trung lap
notwithstanding: bat chap, tuy nhien, the ma
neuropsychology: tam than kinh
nonhierarchical: khong co thu bac
neurophysiology: sinh ly hoc than kinh
nonintervention: khong can thiep
neurofibrillary: soi than kinh
nationalization: cho nhap tich
noncontributory: khong thuoc quyen so huu
normativenesses: quy pham
menu: thuc don
most: hon het, phan lon
mate: ban, ban nghe: giao phoi
more: hon, nhieu hon nua, them
many: vo so, nhieu
move: di chuyen
main: chu yeu
meet: gap go
milk: sua
moon: mat trang
male: trai, trong, duc: con trai, dan ong, con trong, duc
mind: san soc
mark: dau, nhan, nhan mac: danh dau, ghi dau
mass: khoi, khoi luong: quan chung, dai chung
meat: thit
melt: tan ra, chay ra: lam tan chay ra
mere: chi la
meat: bua an
mild: nhe, em diu, on hoa
mess: tinh trang bua bon, tinh trang lon xon: nguoi nhech nhac, ban thiu
mile: dam (do luong)
mood: loi, thuc, dieu
mail: thu tu, buu kien: gui qua buu dien
money: tien
movie: phim
magic :ma thuat, ao thuat: (thuoc) ma thuat, ao thuat
march: thang ba
marry: cuoi (vo), lay (chong)
mayor: thi truong
media: truyen thong
metal: kim loai
major: chinh
means: cua cai, tai san, phuong tien
might: co the
metre (bre) (name meter) : met
minor: nho hon, thu yeu, khong quan trong
mixed: lan lon, pha tron
model: mau, kieu mau
month: thang
moral: dao duc, luan ly, pham hanh: co dao duc
music: am nhac
motor: dong co mo to
mount: leo, treo: nui
mouse: chuot
match: tran dau
mouth: mieng
method: phuong phap
member: thanh vien
minute: phut
matter: van de
memory: ky uc
master: bac thay
mainly: chinh, chu yeu, phan lon
manage: quan ly, trong nom, dieu khien
manner: cach, loi, kieu: dang, ve, thai do
market: thi truong
medium: trung binh, trung, vua: su trung gian, su moi gioi
mental: thuoc) tri tue, tri oc: mat tri
moving: di chuyen
merely: chi, don thuan
middle: giua
method: phuong phap, cach thuc
midday: trua, buoi trua
mobile: chuyen dong, di dong
monday: thu 2
moment: choc lat
mostly : hau het, chu yeu la
murder: toi giet nguoi, toi am sat: giet nguoi, am sat
muscle: co, bap thit
museum: bao tang
million: trieu
meeting: cuoc hop, cuoc gap go
meaning: co y tot, y nghia
measure: do luong, do kich thuoc
machine: may moc
manager: nguoi quan ly
married: cuoi, ket hon
massive: to lon, do so
mention: ke ra, noi den, de cap
medical: y khoa
mineral: cong nhan, tho mo: khoang
minimum: toi thieu: so luong toi thieu, muc toi thieu
morning: buoi sang
missing: vang, thieu, that lac
mistake: loi, sai lam, loi lam: pham loi, pham sai lam
mixture: su pha tron, su hon hop
message: tin nhan, thong diep
morally: co dao duc
material: nguyen lieu, vat lieu
military: quan doi, quan nhan
movement: su di dong, phong trao
magazine: tap chi
minister: bo truong, muc su
midfield: tien ve
magazine: tap chi
maintain: duy tri
maintain: giu gin, duy tri, bao ve
marriage: su cuoi xin, su ket hon, le cuoi
mortgage: the chap, su cho muon
matching: tinh dich thu, thi dau
multiple: nhieu, kep
medicine: y hoc, y khoa: thuoc
majority: so dong, da so
mountain: nui
mechanism: co che, su to chuc
magnitude: tam quan trong
meanwhile: trong luc ay, trong khi ay
migration: di cu
municipal: thuoc ve do thi
mortality: tu vong
molecular: phan tu, thuoc ve phan tu
machinery: may moc
materially: vat chat
misleading: gay hieu lam
motivation: dong luc
meaningful: co y nghia
membership: tu cach hoi vien
mainstream: xu huong
multimedia: da phuong tien
management: su quan ly
mechanical: khong suy nghi, co khi
mysterious: huyen bi
mathematics: toan hoc
maintenance: bao tri, tien bao duong
marketplace: thuong truong
methodology: phuong phap luan, phuong phap nghien cuu
meaningless: vo nghia
magnificent: trang le, long lay
manufacture: san xuat
merchandise: hang hoa
measurement: su do luong, do dac
multifamily: da gia dinh
multiplayer: nhieu nguoi choi
ministerial: bo tro, bo truong
modification: sua doi, su giam bot
manipulative: thao tung, loi keo
metropolitan: thuoc ve thu do, dan o thu do
mathematical: toan hoc, thuoc ve toan hoc
metaphysical: sieu hinh
multilateral: da phuong
manipulation: thao tac, su van dong
manufacturer: nha san xuat, nha che tao
municipality: thi tran, thanh pho
multinational: da quoc gia
merchandising: buon ban
misconception: ngo nhan
magnification: phong dai
manifestation: bieu hien, su bieu lo
microcomputer: may vi tinh
misunderstood: hieu lam, hieu khong ro
multicultural: da van hoa
miscellaneous: dieu khoan khac, lan lon
mediterranean: dia trung hai
metamorphosis: su bien hinh
multiplication: phep nhan
multiplicative: phep nhan
microevolution: tien hoa vi mo
metalinguistic: kim loai
macroeconomics: kinh te vi mo
microprocessor: bo vi xu ly
multifactorial: da yeu to
microeconomics: kinh te vi mo
microstructure: cau truc vi mo
mountaineering: leo nui
misappropriate: thich hop
multifunctional: da chuc nang
multiprocessing: da che bien, da xu ly
mischaracterize: nham lan, hieu sai
monounsaturated: chat beo, khong bao hoa don
misconstruction: su nham lan
oil: dau
one: mot, so mot
off: tat: khoi, cach, roi
old: cu
odd: ky quac, ky cuc, le (so)
out: ngoai
once: mot lan, ngay xua
only: chi
obey: tuan theo, vang loi
open: mo
often: thuong xuyen
onion: cu hanh
opera: nhac kich
ought: phai
order: dat hang
other: khac
ocean: dai duong
obese: beo phi, bung phe
outer: ben ngoai
olive: oliu
onset: su khoi dau
optic: quang hoc
oasis: oc dao
occur: xay ra
organ: so quan, dan organ
owing: no, thieu
otter: con rai ca
overt: cong khai, ro rang
opium: thuoc phien
optics: quang hoc
option: lua chon
object: vat the, muc dich
orange: qua cam
outcry: phan doi
offset: bu lai
outlaw: ngoai vong phap luat
oracle: tien tri, nha tien tri
office: van phong
occupy: giu, chiem
output: suc san xuat, dau ra
overly: qua muc, nhieu qua
orient: dinh huong
orphan: mo coi
obtain: dat duoc
outlay: ra ngoai
opaque: mo mit
onward: tro di, xa hon
occult: huyen bi, bi mat
overall: tong the
outside: o ngoai
operate: co tac dung, van hanh
officer: nhan vien van phong
opening: khai mac
offense: xuc pham
obscure: mo mit
obvious: hien nhien
opinion: y kien
optimal: toi uu
observe: quan sat
ongoing: dang dien ra
outline: de cuong
outlook: quan diem
offline: ngoai tuyen
outrage: su phan no
oversee: giam sat
ovation: su reo mung, su vui mung
overlap: chong len nhau
oneself: ban than
orchard: vuon cay an qua
overdue: qua han
obesity: chung map, beo phi
ordinal: thu tu
orderly: co trat tu
onshore: tren bo
outward: be ngoai
oceanic: hai duong
ostrich: con da dieu
offload: giam tai
obviate: xoa so
offence: xuc pham
obscene: ghe gom, tuc tiu
oversaw: trong nom, giam sat
outback: heo lanh
osmosis: su tham thau
ominous: diem xau, dang ngai
offbeat: khac thuong
opacity: su u me
original: nguyen ban
organize: to chuc
overseas: hai ngoai
official: chinh thuc
ordinary: binh thuong
opposite: doi dien
offering: chao ban
optional: khong bat buoc
opponent: phan doi
operator: nha dieu hanh
otherwise: neu khong thi
ourselves: chinh chung ta
organized: co to chuc
ordinance: sac lenh
objective: muc tieu
operation: hoat dong
offensive: phan cam
objection: su phan doi
overnight: qua dem
offspring: con de, con cai
ownership: quyen so huu
outspoken: thang than, nguoi ngay thang
occupancy: chiem dung
orchestra: dan nhac
obsession: am anh
originate: bat nguon
outsource: thue ngoai
obedience: vang loi, nghe loi
outskirts: ngoai o
obligation: nghia vu
opposition: su doi dau
oppression: su ap buc
occurrence: tan suat xay ra, bien co
occupation: nghe nghiep
outpatient: benh nhan ngoai tru
outfielder: tien ve
ocasional: thinh thoang
ordinarily: binh thuong
outpouring: chay ra, su tuon ra
oppressive: ap buc
observable: co the thay, trong thay
obligatory: bat buoc
outrageous: tan nhan
outperform: vuot troi
obliterate: boi, cao
orthogonal: truc giao
ophthalmic: thuoc ve mat
ornamental: trang tri
obstetrics: khoa san
occidental: ngau nhien
outlandish: la lung, ky di
overburden: bat ganh vac, qua tai
ostensible: be ngoai, tu xung
overshadow: lam lu mo, che mat
overgrowth: phat trien qua muc
outcompete: canh tranh
osmolarity: do tham thau
oratorical: hinh bau duc
omnipotent: toan nang, thuong de
oversupply: cung cap qua muc
overbought: mua qua nhieu
overcharge: qua tai
osteopathy: nan xuong
overcommit: thua nhan
otherworld: the gioi khac
omniscient: toan tri, toan thuc
organicism: chu nghia huu co
outstation: tram dung chan
opportunity: co hoi
operational: hoat dong
officialese: chinh thuc
objectivity: tinh khach quan
observation: quan sat
outstanding: noi bat
obstruction: su can tro
orthopedics: chinh hinh
orientation: su dinh huong
observatory: dai quan sat
outmaneuver: vuot qua
overarching: bao quat
orchestrate: dan dung
originality: doc dao
overbearing: hong hach
oscillation: su lung lay
overzealous: qua hang hai
opprobrious: hung du
opinionated: khang khang, ngoan co
overwrought: qua suc
outdoorsman: nguoi ngoai troi
overweening: tran ngap
omnipresent: co mat khap noi
outbuilding: xay dung
outsourcing: gia cong phan mem
overindulge: qua muc
orthostatic: the dung
opportunist: nguoi co hoi
overbalance: mat thang bang
overcorrect: qua dung dan
occasionally: thinh thoang
osteoporosis: loang xuong
organization: co quan, to chuc, cach cau tao, su giu gin
occupational: nghe nghiep
ossification: hoa thach
overpowering: che ngu
overestimate: danh gia qua cao
ostentatious: pho truong
obstetrician: bac si san khoa
overwhelming: choang ngop
overcapacity: du thua
officeholder: chu van phong
otherworldly: the gioi khac
orthographic: chinh hinh
orienteering: dinh huong
osteosarcoma: u xuong
overpopulate: dan so qua dong
obstreperous: chuong tai
outplacement: su thay the
overpressure: qua ap
optimization: toi uu hoa
overcautious: can than
oscillograph: dao dong
overfamiliar: qua quen
obliteration: su xoa so
overregulate: kiem soat qua muc
oversimplify: don gian hoa qua muc
overgenerous: qua nhieu
overpersuade: qua suc
olfactometer: may do khuu giac
overmedicate: thai qua
osteoplastic: chat tao xuong
opinionative: co chap
orchidaceous: hoa phong lan
orthotropous: chinh hinh
orthogenesis: su phat sinh
obliterating: xoa so
osteomalacia: nhuyen xuong
obfuscations: su xao tron
overabundance: du thua
opportunistic: co hoi
ophthalmology: nhan khoa
ornamentation: vat trang tri
oversensitive: khong nhay cam
osteomyelitis: viem tuy xuong
overemphasize: nhan manh qua muc
objectionable: phan doi
overqualified: thua nang luc
overcommitted: thua nhan
overutilizing: su dung qua muc
overconfident: thua su tu tin
overambitious: qua tham vong
orchestration: su dan dung
occidentalize: ngau nhien
overdominance: vuot troi
ovipositional: thuoc ve than tuong
oppositionist: nguoi chong doi
overstability: noi qua
overstatement: phong dai
obstructionist: nguoi can tro
overpopulation: dan so qua dong
organochlorine: clo huu co
oncogenicities: nhung nguoi co toi
otolaryngology: khoa tai mui hong
overcompensate: bu dap qua muc
overgeneralize: tong quat hoa qua muc
osteoarthritis: viem xuong khop
overoptimistic: qua muc
ostentatiously: pho truong
overcapitalize: thua suc song
operationalism: chu nghia hoat dong
overprivileged: qua dac quyen
overspecialize: qua chuyen mon hoa
orthographical: chinh hinh
overproportion: qua ty le
oversolicitous: thai qua
ornithological: loai chim choc
oscillographic: dao dong
overscrupulous: vo dao duc
openhandedness: coi mo
organometallic: kim loai
onchocerciases: benh ung thu
optoelectronics: quang dien tu
offensivenesses: su xuc pham
ophthalmologist: bac si nhan khoa (nhan khoa y hoc)
ontogenetically: ve mat di truyen
operativenesses: tac nghiep
occidentalizing: ngau nhien
omnidirectional: da huong
obstructionisms: chuong ngai vat
orthopsychiatry: khoa tam than hoc
obsessivenesses: am anh
obstinatenesses: su co chap
observationally: quan sat
overrepresented: dai dien qua muc
oceanographical: hai duong hoc
oversaturations: du thua
objectification: su khach quan hoa
osmoregulations: loi chuc mung
observabilities: kha nang quan sat
pass: vuot qua
pink: mau hong
pace: buoc chan, buoc
pain: su dau don, su dau kho
pair: doi, cap
pale: tai, nhot
peak: dinh cao, suy yeu
park: cong vien, vuon hoa: khoanh vung thanh cong vien
part: phan, bo phan
past: qua khu, di vang: qua, qua
path: duong mon: huong di
peak: luoi trai: dinh, chop
push: thuc day
pack: goi, boc: bo, goi
pick: cuoc (dat): dao, khoet (lo)
poor: ngheo
pile: coc, chong, dong, pin: dong coc, chat chong
pill: vien thuoc
pipe: ong dan (khi, nuoc…)
pity: long thuong hai, dieu dang tiec, dang thuong
plan: ban do, ke hoach: ve ban do, lap ke hoach, du kien
play: choi, danh: su vui choi, tro choi, tran dau
plot: manh dat nho, so do, do thi, do an: ve so do, dung do an
plug: nut (thung, chau, bo(n)..)
pole: nguoi ba lan: cuc (nam cham, trai dat…)
pool: vung nuoc: be boi, ho boi
port: cang
pose: dua ra, de ra, dat: su dat, de ra
post: thu, buu kien: gui thu
pour: rot, do, gioi
pull: loi, keo, giat: su loi keo, su giat
pure: nguyen chat, tinh khiet, trong lanh
push: xo day: su xo day
prize: giai thuong
place: dia diem
party: bua tiec
paper: to giay
prime: toi pham
prove: chung minh
piece: cai, gia
proof: bang chung
peace: thai binh, su thanh binh
plate: dia, tam o khoa
pilot: phi cong
paint: son, voi mau: son, quet son
panel: van o (cua, tuong), pa no
panel: bang dieu khien
phone: dien thoai
pants: quan lot, dui
pause: tam nghi, dung: su tam nghi, su tam ngung
proud: tu hao, kieu cang
plant: cay coi
power: quyen luc
piano: dan piano, duong cam
pitch: san (choi cac mon the thao): dau hac in
plain: ngay thang, don gian, chat phac
plane: mat phang, mat bang
plate: ban, tam kim loai
point: mui nhon, diem: vot, lam nhon, cham (cau..)
pound: pao – don vi do luong
press: su ep, su nen, su an: ep, nen, bop, an
price: gia
prior: truoc, nguyen thuy, dau tien
pride: su kieu hanh, su hanh dien: tinh kieu cang, tu phu
print: in, xuat ban: su in ra
prior: truoc, uu tien
prize: giai, giai thuong
phase: bieu tuong, giai doan
proof: chung, chung co, bang chung: su kiem chung
proud: tu hao, kieu hanh
pupil: hoc sinh
proper: thich hop
people: moi nguoi
person: nguoi
profit: loi nhuan
plenty: su chan chua
picked: hai, nhat
pursue: duoi theo, theo duoi
patent: bang sang che
packet: goi nho
partly: tung phan, tung doan
palace: cung dien, lau dai
parent: cha, me
pencil: but chi
pepper: hat tieu, cay ot
perhaps: co the, co le
public: cong dong
permit: cho phep, cho co hoi
person: con nguoi, nguoi
proven: chung minh
phrase: cau: thanh ngu, cum tu
period: giai doan
prison: nha tu
planet: hanh tinh
police: canh sat
player: nguoi choi 1 tro choi nao do (nhac cu)
pocket: tui (quan ao, trong xe hoi), tui tien
prefer: thich hon
poetry: thi ca: chat tho
poison: chat doc, thuoc doc: danh thuoc doc, tam thuoc doc
policy: chinh sach
polish: nuoc bong, nuoc lang: danh bong, lam cho lang
polite: le phep, lich su
potato: khoai tay
powder: bot, bui
prince: hoang tu
praise: su ca ngoi, su tan duong, long ton kinh, ton tho: khen ngoi, tan duong
prayer: su cau nguyen
priest: linh muc, thay tu
provide: cung cap
problem: van de
present: cho den nay, hien tai
program: chuong trinh
popular: pho bien
private: rieng tu
purpose: muc dich
product: san pham
percent: phan tram
partner: dong nghiep, ban dong hanh
process: qua trinh, quy trinh
picture: buc tranh, buc anh
project: du an
patient: kien nhan
payment: su thanh toan
package: goi do, buu kien: dong goi, dong kien
painful: dau don, dau kho
perhaps: co le, khong chung
primary: so cap
passing: su di qua, su troi qua: thoang qua, ngan ngui
passage: su di qua, su troi qua: hanh lang
patient: benh nhan: kien nhan, nhan nai, ben chi
pattern: mau, khuon mau
pension: tien tro cap, luong huu
perfect: hoan hao
physics: vat ly hoc
plastic: chat deo, lam bang chat deo
pointed: nhon, co dau nhon
property: bat dong san
personal: rieng tu, ca nhan
possible: kha thi, co the lam duoc
practice: am muu, thuc hanh
provided: cung cap, thuoc ve cung cap
previous: truoc, voi vang, gap gap
position: chuc vu, thai do
powerful: nang luong
probably: co le
positive: tich cuc, cuong quyet
pursuant: hoan toan
purchase: mua ban
presence: su hien dien, su co mat
progress: phat trien
pressure: suc ep
platform: nen tang
priority: su uu tien
physical: vat ly, thuoc ve vat chat
producer: nguoi san xuat
prospect: tiem nang
printing: in an
proposal: de nghi
pleasure: lam vua long, vui long
potential: tiem nang, tiem luc
principal: hieu truong, quan trong, chu yeu
plaintiff: nguyen don
permanent: dai han, luon luon, thuong xuyen
president: chu tich, giam doc
professor: giao su
precision: do chinh xac, tinh ro rang
prominent: noi bat
portfolio: danh muc dau tu
principle: nguyen tac
procedure: thu tuc, phuong thuc
publisher: nha xuat ban, nguoi phat hanh
provision: dieu khoan, cung cap, cap duong
promotion: thang chuc, cai tien
perfectly: hoan hao, khong khuyet diem
practical: thuc dung, tien loi
programme: chuong trinh
precisely: ti mi
pollution: su o nhiem
passenger: hanh khach
promising: hua hen, day hy vong
packaging: bao bi
publicity: cong khai
production: san xuat
population: dan so
photograph: anh chup, chup hinh
protection: su bao ve
profitable: co lai
percentage: ty le phan tram
permission: su cho phep, su chap thuan
particular: cu the
profession: nghe nghiep
phenomenon: hien tuong
proportion: ty le
productive: nang suat
prevention: phong ngua, su ngan can
philosophy: triet hoc
parliament: nghi vien
personally: ca nhan
perception: nhan thuc, su ly giai
preference: so thich
possession: chiem huu, thuoc dia
persistent: kien tri
partnership: su hop tac
perspective: goc nhin ca nhan
probability: xac suat
performance: hieu suat
publication: su xuat ban, su cong bo
programming: lap trinh
progressive: cap tien
proprietary: doc quyen
preliminary: so bo
personality: nhan vat, nhan cach
proposition: menh de, dieu du dinh
possibility: kha nang, tinh trang
prestigious: uy tin
problematic: co van de, mo ho
preparation: su chuan bi
practically: thuc te
prospective: co trien vong
participant: nguoi tham gia
participate: tham du
prosecution: truy to, su theo duoi
progression: su tien trien
provisional: tam thoi
predecessor: nguoi tien nhiem
presentation: bai thuyet trinh
particularly: dac biet, can ke
prescription: don thuoc
proportional: can doi, ty le thuan
productivity: nang suat
proclamation: tuyen ngon
presidential: tong thong
photographic: chup anh
psychologist: nha tam ly hoc
practitioner: nguoi hanh nghe
preventative: ngan ngua
presbyterian: nguoi gia
psychiatrist: bac si tam ly
professional: chuyen nghiep
policyholder: chu hop dong
preferential: uu dai
preparedness: su chuan bi
pathological: benh ly
postgraduate: sau dai hoc
peacekeeping: gin giu hoa binh
pharmacology: duoc ly hoc
philanthropy: tu thien
proscription: loi to cao, su cam doan
permeability: tham
polarization: su phan cuc
pediatrician: bac si nhi khoa
paramilitary: ban quan su
patriarchate: gia truong
perseverance: kien tri
pacification: su binh dinh
pathbreaking: su pha vo
premalignant: tien ac tinh
proportionate: tuong xung
probabilistic: xac suat
psychological: tam ly
preoccupation: ban tam
pronunciation: cach phat am
pronouncement: loi tuyen bo
participation: su tham gia
precipitation: luong mua
participatory: co su tham gia
parliamentary: nghi vien
physiotherapy: vat ly tri lieu
paraphernalia: vat dung
preponderance: uu the
perpendicular: vuong goc
precautionary: de phong
postoperative: hau phau
protectionism: chu nghia bao ho
photosynthesis: quang hop, su quang hop
polymerization: su trung hop
predestination: su tien dinh
phytochemistry: hoa thuc vat
pharmaceutical: duoc pham
prepublication: su xuat ban
periodontology: sinh vat hoc
postmenopausal: tien man kinh
photochemistry: quang hoa hoc
predisposition: khuynh huong, khuynh huong ve
parapsychology: tam ly hoc
proprioception: su khoi dau
prohibitionist: nguoi cam doan
prosthodontics: rang gia
preadolescence: thoi ky thieu nien
preconsciously: chinh xac
petrochemistry: hoa dau
photosensitive: cam quang
parallelepiped: song song
paralinguistic: thuoc ve ngon ngu
phytopathology: nganh thuc vat hoc
preconditioned: dieu chinh truoc
parliamentarian: nghi si, nghi vien, thuoc ve nghi si
physicochemical: hoa ly
psychotherapist: nha tri lieu tam ly
photojournalism: phong vien anh
prepresidential: tien bao ke
personification: nhan cach hoa
professionalism: su chuyen nghiep
preregistration: dang ky truoc
preprofessional: chuyen nghiep
plenipotentiary: toan quyen, duoc toan quyen
psychoacoustics: thuoc tam than
pharmacotherapy: lieu phap duoc
popularizations: pho bien
preservationist: nguoi ban ton
parthenogenesis: sinh san
precipitinogens: chat ket
quiz: cau do
quit: bo cuoc
quick: nhanh chong, mau le, gon gang
query: truy van
quell: dap tat
quilt: may chan
quite: kha, toan ven
quirk: ky quac
quods: bat giam
queer: nguoi ky la
quota: han nghach
quill: long nhim
quash: huy an
queues: hang doi
quaint: ky la
quench: dap tat
quorum: tuc so
quiver: run
quarry: mo da
quanta: luong tu
queasy: buon non
quills: but long
quinta: ta
quoted: trich dan
quarter: phan tu
quantum: luong tu
quickie: nhanh len
quietly: lang le
quality: chat luong
quibble: khong phan minh
queller: nguoi ban hang
queries: truy van
quarrel: cuoc tranh cai
queerer: nguoi hoi
quiches: nhanh chong
quester: nguoi hoi tham
quantity: dinh luong
quotient: thuong so
quippier: vui ve hon
question: cau hoi
quagmire: vung lay
quartile: phan tu
quartier: nguoi khai thac
quixotic: anh hung rom
quietude: im lang
quietism: chu nghia lap di
quisling: lam phien
quandary: noi kho khan
quantile: luong tu
quickset: hang rao cay
quirting: noi doi
quiverer: nguoi run ray
quagmires: vung lay
quipsters: cau do
quivering: run ray
qualifies: du tieu chuan
quantizer: bo dinh luong
quitrents: bo viec
quaggiest: tim kiem
quadroons: hinh tu giac
quantities: so luong
qualifiers: vong loai
quaintness: su ky la
quantizers: may dinh luong
quadrature: cau phuong
qualifying: du tieu chuan
quotations: trich dan
quantizing: luong hoa
quadrivial: tam thuong
quizzically: ky quac
quantifying: dinh luong
quadrangles: hinh tu giac
qualifiedly: du tieu chuan
quarrelling: cai nhau
quarantines: cach ly
quotability: kha nang bao gia
quaveringly: run ray
quarantining: cach ly
quarterfinal: tu ket
quantitative: dinh luong
quadrivalent: hoa tri bon
quintessence: tinh hoa
quantization: luong tu hoa
quadripartite: tu phuong
quartermaster: quy truong
questionnaire: bang cau hoi
quadrilateral: tu giac
quantizations: luong hoa
quarterbacked: ho tro
quadruplicate: gap bon
quincentenary: tu quy
quantitations: dinh luong
quantitatively: dinh luong
quizzicalities: su ky la
questionnaires: bang cau hoi
quintessential: tinh tuy, thuoc ve tinh tuy
qualifications: bang cap
quintuplicated: nhan doi
querulousnesses: ky quac
quatercentenary: bac bon
quarrelsomeness: cai va
quarterfinalist: tu ket
rate: ty le, khien trach
rice: gao, thoc, com: cay lua
road: con duong
rest: nghi ngoi
role: luat le, quy dinh, vai tro
race: loai, chung, giong: cuoc dua: dua
rail: duong ray
risk: rui ro
rain: mua, con mua: mua
ring: nhan
rank: hang, day: sap xep thanh hang, day
real: thuc te thuc su
rare: hiem, it
rear: phia sau: o dang sau, o dang sau
read: doc
rent: su thue muon: cho thue, thue
rose: hoa hong
rest: su nghi ngoi, luc nghi: nghi, nghi ngoi
rich: giau, giau co
rise: su len, su tang luong, thang cap: day, dung len, moc (mat troi), thanh dat
rock: da
role: vai (dien), vai tro
roll: cuon, cuon, su lan tron: lan, cuon, quan, cuon
roof: mai nha, noc
room: phong, buong
root: goc, re
rope: day cap, day thung, xau, chuoi
rude: bat lich su, tho lo: tho so, don gian
ruin: lam hong, lam do nat, lam pha san: su hong, su do nat, su pha san
rule: quy tac, dieu le, luat le: cai tri, chi huy, dieu khien
rush: xong len, lao vao, xo day: su xong len, su lao vao, su xo day
right: dung, hoan toan
round: tron, xung quanh
ready: san sang, chuan bi cho viec gi
react: tac dong tro lai, phan ung
radio: dai radio
reach: cham toi, dua ra
rapid: nhanh, mau le, ngay thang
range: xep hang, pham vi
raise: nang cao, gay ra
royal: hoang gia, long lay
refer: tham khao
route: lo trinh
river: con song
rough: tho, gap ghenh
ratio: ty le
reject: khong chap nhan, loai bo, bac bo
result: ket qua
recent: gan day, moi day
reckon: tinh, dem
return: su den bu, tro ve
reason: ly do, duyen co
reduce: giam
remain: con lai, do an du thua
racing: cuoc dua
rarely: hiem khi, it khi
reform: cai cach, canh tan
reader: nguoi doc, doc gia
recall: goi ve, trieu hoi: nhac lai, goi lai
report: bao cao
region: vung, mien
regret: dang tiec, hoi tiec: long thuong tiec, su hoi tiec
relate: ke lai, thuat lai: lien he, lien quan
rather: hon, chut it
relief: su giam nhe, su lam cho khuay khoa: su tro cao: su den bu
remark: su nhan xet, phe binh, su de y, chu y: nhan xet, phe binh, de y, chu y
really: co that khong?
remind: nhac nho, goi nho
remote: xa, xa xoi, xa cach
rented: duoc thue, duoc muon
record: ghi lai
repair: sua chua, chinh tu: su sua chua, su chinh tu
repeat: nhac lai, lap lai
report: bao cao, tuong trinh: ban bao cao, ban tuong trinh
rescue: giai thoat, cuu nguy: su giai thoat, su cuu nguy
resist: chong lai, phan doi, khang cu
resort: ke sach, phuong ke
result: ket qua: boi, do.. ma ra, ket qua la…
retain: giu lai, nho duoc
retire: roi bo, rut ve: thoi, nghi viec, ve huu
return: tro lai, tro ve: su tro lai, su tro ve
reveal: boc lo, bieu lo, tiet lo: phat hien, kham pha
reward: su thuong, phan thuong: thuong, thuong cong
riding: mon the thao cuoi ngua, su di xe (bus, dien, xe dap)
rubber: cao su
rudely: bat lich su, tho lo: tho so, don gian
ruined: bi hong, bi do nat, bi pha san
rumour: bin don, loi don
runner: nguoi chay
release: giai phong, giay bien nhan
receive: tiep dai, tiep don, nhan duoc
remains: con lai
routine: thoi thuong, le thuong, thu tuc: thuong le, thong thuong
rapidly: nhanh, nhanh chong
require: yeu cau, can dung
reality: thuc the, su that
revenue: doanh thu, tien loi, loi tuc
respect: ton trong, kinh trong
reflect: phan chieu, nghi ngoi, doi lai
regular: deu dan, thuong xuyen
request: yeu cau, doi hoi
related: lien quan, co dinh dang
railway: duong sat
respond: tra loi
running: dang chay, lien tiep
rightly: dung, phai, co ly
rounded: bi lam thanh tron: phat trien day du
rubbish: vat vo gia tri, bo di, rac ruoi
relative: quan he, tuy theo
relevant: lien quan, thich hop
research: nghien cuu
received: nhan, co nhan
remember: nho
response: su dap lai, phan ung
repeated: lap di lap lai
resource: nguon, phuong phap, phuong sach
required: can thiet
recovery: su tim lai, su hoi phuc
register: dang ky
reliable: dang tin cay
regional: khu vuc
reaction: phan ung
republic: cong hoa, doan the
recognize: nhin nhan, cong nhan, nhan biet
represent: dai dien
recording: ghi am
reception: tiep nhan
radiation: su phong xa
relevance: su lien quan, su thich dang
retention: giu lai, su tu che
remainder: phan con lai
religious: ton giao
regarding: chu y, de y
realistic: thuc te, hien thuc
reduction: giam bot
recommend: gioi thieu, dan do
recession: suy thoai
residence: noi cu tru, cho o
reluctant: luong lu, mien cuong
redundant: du thua, ruom ra
relatively: tuong doi
restricted: han che
reasonable: hop ly
regardless: bat ke, khong de y
resolution: su phan giai
reputation: uy tin, danh tieng
restaurant: nha hang
receivable: phai thu, co bien lai
respective: tuong ung
registered: da dang ky
recreation: giai tri, su tai tao
regulation: quy dinh, co quy tac
reportedly: duoc bao cao
reflection: su chi trich, su phan chieu
revolution: cuoc cach mang, cuoc troi day, cuoc khoi nghia
resistance: su chong cu, suc can
remarkable: dang chu y
republican: cong hoa
retirement: su nghi huu
repeatedly: nhieu lan, nhac lai
roundtable: ban tron
redemption: su mua chuoc, chuoc loi
responsive: phan ung nhanh nhen
recognition: su cong nhan, su thua nhan
respiratory: ho hap, thuoc ve ho hap
requirement: su yeu cau
reservation: su han che, su gioi han
restoration: su phuc hoi, su hoan lai
responsible: chiu trach nhiem, dang tin cay
resignation: su tu chuc
renaissance: su phuc hung
realization: hien thuc hoa
recombinant: tai to hop
residential: khu dan cu
restriction: su han che
respectable: dang kinh, dung dan
replacement: su thay the
rebroadcast: phat lai
radioactive: phong xa, co nang luc phong xa
restrictive: giam bot
restructure: tai cau truc
replication: nhan rong, dap lai
reclamation: su cai thien, khai khoang
reconstruct: tai tao lai
reformation: su sua doi
rectangular: hinh hop chu nhat
rationality: tinh hop ly
radiotherapy: xa tri
respectively: tuong ung
reproduction: sinh san
recreational: giai tri
receivership: su tiep nhan
reproductive: sinh san, sinh thuc
resurrection: hoi sinh, su phuc hung
regenerative: tai sinh, tai tao
registration: dang ky, su ghi ten
regeneration: su cai tao, su tai tao
receivership: su tiep nhan
refrigerator: tu lanh, phong lanh
remuneration: su khen thuong, thu lao
relationship: moi quan he
recollection: hoi uc, tinh tam
rehabilitate: phuc hoi, khoi phuc
receptionist: le tan, nhan vien tiep khach
recalcitrant: buong, ngoan co
reinvigorate: hoi sinh
retrospective: hoi tuong, nhin lai qua khu
revolutionize: cach mang hoa
reverberation: tieng vang
revolutionary: cach mang, khoi nghia
reincarnation: luan hoi
radioactivity: phong xa, su phong xa
recombination: su tai hop
rapprochement: su hop tac
recrystallize: ket tinh lai
reprographics: in lai
refractometer: khuc xa ke
reprehensible: dang trach, trach mang
reciprocation: su dap tra
reinforcement: quan tiep vien, cung co
reflectometer: may do phan xa
reverberatory: tieng vang
republication: nen cong hoa
resegregation: su phan chia
retrogression: su vi pham, su suy doi
recrimination: su thong tri
reorganization: to chuc lai
renegotiations: dam phan lai
representative: tieu bieu
recommendation: su gioi thieu
respectability: su ton trong
reconstruction: tat thiet, trung tu lai
redistributive: phan phoi lai
responsibility: nhiem vu
redistribution: phan phoi lai, chia cat lai
reconnaissance: su do tham, su do xet
reconstructive: tai tao
representation: su dien ta, dai dien
recapitulation: su tom tat, tom luoc
reconciliation: hoa giai
redevelopments: tai phat trien
remonetization: lam lai
reaccreditation: cong nhan lai
radiotelegraphy: may ghi am vo tuyen
retransmissions: truyen lai
remanufacturing: tai san xuat
regularizations: quy dinh
rationalization: su hop ly, hop ly hoa
rememberability: kha nang nho
revitalizations: su hoi sinh
remonstratively: con lai
regionalization: khu vuc hoa
remobilizations: su di doi
resurrectionist: nguoi hoi sinh
reductivenesses: giam bot
restrictionists: nhung nguoi han che
refortification: su cai to
retroreflectors: phan xa
restrictiveness: su han che
revolutionaries: nha cach mang
sun: mat troi
see: thay
son: sua con
she: co ay
sum: tong, toan bo
sit: ngoi
sky: troi, bau troi
six: so sau
sex: gioi, giong
shy: nhut nhat, e then
sir: xung ho lich su ngai, ong
sew: may, khau
sad: buon, buon ba
some: mot vai
site: dia diem
sale: ban
same: deu deu, don dieu: cung nhu the, van cai do
soon: som
stay: o lai
such: nhu la
seed: hat, hat giong
send: gui
shop: cua hang: di mua hang, di cho
star: ngoi sao
sack: bao tai: dong bao, bo vao bao
safe: an toan, chac chan, dang tin
said: noi
sign: ky ten
show: cho xem
sail: di tau, thuyen, nho neo: buom, canh buom, chuyen di bang thuyen buom
salt: muoi
sale: viec ban hang
sure: chac chan, bao dam
sand: cat
save: cuu, luu
seal: hai cau: san hai cau
seat: ghe, cho ngoi
stop: dung lai
seek: tim, tim kiem, theo duoi
self: ban than minh
ship: tau, tau thuy
shoe: giay
seem: duong nhu
shot: dan, vien dan
show: bieu dien, trung bay: su bieu dien, su bay to
shut: dong, khep, day: tinh khep kin
sick: om, dau, benh
side: mat, mat phang
sign: dau, dau hieu, ki hieu: danh dau, viet ky hieu
silk: to, chi, lua
sing: hat, ca hat
sink: chim, lun, dam
size: co
skin: da, vo
slip: truot, tuot, troi qua, chay qua
slow: cham, cham chap
snow: tuyet: tuyet roi
soap: xa phong
sock: tat ngan, mieng lot giay
soft: mem, deo
soil: dat trong: vet ban
song: bai hat
sore: dau, nhuc
sort: thu, hang loai: lua chon, sap xep, phan loai
soul: tam hon, tam tri, linh hon
soup: xup, canh, chao
sour: chua, co vi giam
spin: quay, quay tron
spot: dau, dom, vet
star: ngoi sao, dan sao, trang tri hinh sao, danh dau sao
stay: o lai, luu lai: su o lai, su luu lai
step: buoc: buoc, buoc di
stir: khuay, dao
suck: bu, hut: hap thu, tiep thu
suit: bo com le, trang phuc: thich hop, quen, hop voi
swim: boi loi
still: van
since: tu
score: diem so, ban thang, ty so: dat duoc, thanh cong, cho diem
staff: nhan vien
short: ngan
space: khong gian
start: bat dau
same: su xau ho, then thung, su nguong
seven: so bay
sense: giac quan
stage: san khau
speed: toc do
sound: am thanh
serve: cu xu
sadly: mot cach buon ba, dang buon la, khong may ma
salad: sa lat (xa lach trong dau dam): rau song
share: chia se
salty: chu vi muoi, co muoi, man
state: tieu bang
sauce: nuoc xot, nuoc cham
south: mien nam
scale: vay (ca..)
small: nho
scare: lam kinh hai, so hai, doa: su so hai, su kinh hoang
shade: bong, bong toi
shake: rung, lac, giu: su rung, su lac, su giu
story: cau chuyen
stock: co phan
shape: hinh, hinh dang, hinh thusharp (adj) /ʃɑrp/ sac, nhon, ben
shell: vo, mai: ve be ngoai
sheep: con cuu
study: hoc tap
sheet: chan, khan trai giuong: la, tam, phien, to
shelf: ke, ngan, gia
shift: doi cho, doi cho, chuyen, giao: su thay doi, su luan phien
shine: chieu sang, toa sang
shiny: sang choi, bong
shirt: ao so mi
shock: su dung cham, va cham, su kich dong, su choang: cham manh, va manh, gay soc
shoot: vut qua, chay qua, nem, phong, ban: dam ra, troi ra
shout: ho het, reo ho: su la het, su ho reo
sized: da duoc dinh co
skill: ky nang, ky sao
skirt: vay, dam
sleep: ngu: giac ngu
slice: mieng, lat mong: cat ra thanh mieng mong, lat mong
slide: truot, chuyen dong nhe, luot qua
slope: doc, duong doc, do doc: nghieng, doc
smart: manh, ac liet
smash: dap, vo tan thanh manh: su dap, vo tan thanh manh
smell: ngui: su ngui, khuu giac
smile: cuoi, mim cuoi: nu cuoi, ve tuoi cuoi
smoke: khoi, hoi thuoc: hut thuoc, boc khoi, hoi
solid: ran: the ran, chat ran
solve: giai, giai thich, giai quyet
sorry: xin loi, lay lam tiec, lay lam buon
space: khoang trong, khoang cach
spare: thua thai, du tru, rong rai: do du tru, do du phong
speak: noi
spell: danh van: su thu hut, su quyen ru, say me
spend: tieu, xai
spice: gia vi
spicy: co gia vi
spite: su gian, su han thu
split: che, tach, chia ra: su che, su tach, su chia ra
spoil: cuop, cuop doat
spoon: cai thia
sport: the thao
spray: may, ong, binh phut, bom, phun: bom, phun, xit
should: nen
shaped: co hinh dang duoc chi ro
school: truong hoc
scream: gao thet, keu len: tieng thet, tieng keu to
strong: khoe khoan
social: xa hoi
street: duong pho
simply: don gian
settle: giai quyet, dan xep, hoa giai, dat, bo tri
senior: cao cap
slight: mong manh, thon, gay
supply: cung cap
season: mua
safety: an toan
summer: mua he
safety: su an toan, su chac chan
sailor: thuy thu
salary: tien luong
scared: bi hoang so, bi so hai
second: thu hai
screen: man che, man anh, man hinh: phim anh noi chung
search: su tim kiem, su tham do, su dieu tra: tim kiem, tham do, dieu tra
single: doc than
source: nguon
season: mua
secret: bi mat: dieu bi mat
sector: khu vuc, linh vuc
secure: chac chan, dam bao: bao dam, giu an ninh
select: chon lua, chon loc
senate: thuong nghi vien, ban giam hieu
senior: nhieu tuoi hon, danh cho tre em tren 11t: nguoi lon tuoi hon, sinh vien nam cuoi truong trung hoc, cao dang
series: loat, day, chuoi
series: loat
system: he thong
severe: khat khe, gay gat (thai do, cu xu): gian di, moc mac (kieu cach, trang phuc, dung nhan)
sewing: su khau, su may va
sexual: gioi tinh, cac van de sinh ly
shadow: bong, bong toi, bong ram, bong mat
shower: voi hoa sen, su tam voi hoa sen
signal: dau hieu, tin hieu: ra hieu, bao hieu
silent: im lang, yen tinh
silver: bac, dong bac: lam bang bac, trang nhu bac
simple: don gian
singer: ca si
sister: chi, em gai
sleeve: tay ao, ong tay
smooth: nhan, tron, muot ma
softly: mot cach mem deo
source: nguon
spoken: noi theo 1 cach nao do
speech: su noi, kha nang noi, loi noi, cach noi, bai noi
spider: con nhen
spread: trai, cang ra, bay ra: truyen ba
spring: mua xuan
square: vuong, vuong van: dang hinh vuong, hinh vuong
stable: on dinh, binh tinh, vung vang: chuong ngua
statue: tuong
steady: vung chac, vung vang, kien dinh
sticky: dinh, nhot
strain: su cang thang, su cang
strean: dong suoi
stress: su cang thang: cang thang, ep, lam cang
strict: nghiem khac, chat che,, khat khe
strike: danh, dap, bai cong, dinh cong: cuoc bai cong, cuoc dinh cong
string: day, soi day
stripe: soc, van, vien
stroke: cu danh, cu don: cai vuot ve, su vuot ve: vuot ve
strong: khoe, manh, ben, vung, chac chan
sudden: thinh linh, dot ngot
suffer: chiu dung, chiu thiet hai, dau kho
suited: hop, phu hop, thich hop voi
sunday: chu nhat
supply: su cung cap, nguon cung cap: cung cap, dap ung, tiep te
surely: chac chan
survey: su nhin chung, su khao sat: quan sat, nhin chung, khao sat, nghien cuu
survey: su nhin chung, su khao sat: quan sat, nhin chung, khao sat, nghien cuu
symbol: bieu tuong, ky hieu
system: he thong, che do
service: dich vu
several: mot vai
serious: dung dan, nghiem trang
sharply: sac, nhon, ben
special: dac biet
section: phan
singing: su hat, tieng hat
society: xa hoi
science: khoa hoc
setting: cai dat
sadness: su buon rau, su buon ba
sailing: su di thuyen
support: ho tro
satisfy: lam thoa man, hai long: tra (no), chuoc toi
scratch: cao, lam xuoc da: su cao, su tray xuoc da
subject: mon hoc
section: muc, phan
service: su phuc vu, su hau ha
serious: nghiem trong
student: sinh vien
servant: nguoi hau, day to
someone: nguoi nao do
similar: giong nhau
shelter: su nuong tua, su che cho, su an nau: che cho, bao ve
shocked: bi kich dong, bi va cham, bi soc
shortly: trong thoi gian ngan, som
success: su thanh cong
shower: voi hoa sen, su tam voi hoa sen
similar: giong nhu, tuong tu nhu
sincere: that tha, thang thang, chan thanh
skilful: tai gioi, kheo tay
skilled: co ky nang, co ky sao, kheo tay: co kinh nghiem,, lanh nghe
smoking: su hut thuoc
society: xa hoi
soldier: linh, quan nhan
special: dac biet, rieng biet
station: tram, diem, don
steeply: doc, cheo leo
stiffly: cung, cung ran, kien quyet
stomach: da day
strange: xa la, chua quen
stretch: cang ra, duoi ra, keo dai ra
striped: co soc, co van
succeed: noi tiep, ke tiep: ke nghiep, ke vi
suppose: cho rang, tin rang, nghi rang
surface: mat, be mat
surname: ho
survive: song lau hon, tiep tuc song, song sot
suspect: nghi ngo, hoai nghi: nguoi kha nghi, nguoi bi tinh nghi
sweater: nguoi ra mo hoi,, ke boc lot lao dong
standard: tieu chuan
secretly: bi mat, rieng tu
security: bao ve
severely: khat khe, gay gat (thai do, cu xu): gian di, moc mac (kieu cach, trang phuc, dung nhan)
strategy: chien luoc
superior: cap tren
scissors: cai keo
security: su an toan, su an ninh
software: phan mem
strength: suc manh
surprise: ngac nhien
sensible: co oc xet doan: hieu, nhan biet duoc
sentence: cau
separate: khac nhau, rieng biet: lam roi, tach ra, chia tay
solution: giai quyet
sexually: gioi tinh, cac van de sinh ly
shocking: gay ra cam phan, toi te, gay kich dong
shooting: su ban, su phong di
shopping: su mua sam
shoulder: vai
sideways: ngang, tu mot ben: sang ben
singing: su hat, tieng hat
smoothly: mot cach em a, troi chay
socially: co tinh xa hoi
software: phan mem
somebody: nguoi nao do
somewhat: den muc do nao do, hoi, mot chut
southern: thuoc phuong nam
spelling: su viet chinh ta
secondary: thu hai
statement: tuyen bo
situation: tinh hinh
satisfied: hai long
sometimes: doi khi
something: mot thu gi do, cai gi do
selection: su lua chon
sensitive: nhay cam
strategic: chien luoc
somewhere: mot vai noi
substance: vi tri
secretary: thu ky
successful: thanh cong
scientific: thuoc ve khoa hoc
strengthen: cung co
subsequent: tiep theo
succession: su ke thua
structural: cau truc
sympathize: thong cam
subsidiary: cong ty con
specialist: chuyen gia, nha chuyen mon
statistics: su thong ke, so lieu thong ke
supplement: phan bo sung
sufficient: du, day du
submission: nop ho so
suggestion: goi y
supportive: ung ho
settlement: giai quyet
stockholder: chu kho
significant: co y nghia
shareholder: co dong
statistical: thong ke
subdivision: su chia nho, su chia ra
sensitivity: nhay cam
substantial: dang ke, ben bi
streamlined: sap xep hop ly
supervision: giam doc, su giam thi
scholarship: hoc bong, su thong thai
supermarket: sieu thi
synthesized: tong hop
spreadsheet: bang tinh
substantive: thuc chat
speculation: suy doan, quan sat
seventeenth: thu muoi bay
segregation: su phan biet
suppression: su dan ap, su bai bo
sympathetic: thong cam
spectacular: canh sac, dep mat
streetwalker: nguoi di duong
schoolmaster: hieu truong, thay giao
sectionalism: chu nghia phan biet
subjectivism: chu nghia chu quan
straightedge: canh thang, goc thang
stupefaction: su ngac nhien, su sung sot
subcomponent: thanh phan phu
sensorimotor: cam bien
semiconductor: chat ban dan
socioeconomic: kinh te xa hoi
significative: co y nghia
sophisticated: tinh vi
supercomputer: sieu may tinh
schoolteacher: giao vien
specification: su chi ro
semicivilized: ban van minh
subcontractor: nha thau phu
supersensible: sieu pham, sieu cam giac
susceptibility: su nhay cam
superstructure: cau truc thuong tang
superscription: ghi tren dau do
specialization: chuyen mon hoa
sensationalism: chu nghia giat gan
stratification: su phan tang
straightjacket: ao khoac
sentimentalize: tinh cam hoa
seroconversion: chuyen doi huyet thanh
supercontinent: sieu luc dia
superconducting: sieu dan
semitransparent: ban trong suot
sympathomimetic: giao cam
straightforward: thang than, chan that
supersaturation: bao hoa
supernaturalism: thuyet sieu nhien
subprofessional: chuyen nghiep
semisubmersible: ban troi chay
supernutritions: sieu dinh duong
superintendence: giam thi
used: da su dung
unto: den
unit: don vi
upon: tren
urge: thuc giuc
user: nguoi dung
undo: hoan tac
ugly: xau xi
until: cho den khi
urban: thanh thi
unlit: khong co den
under: duoi
usual: binh thuong
usage: su dung
unity: thong nhat
upper: phia tren
unmet: chua duoc dap ung
undue: thai qua
union: lien hiep
ultra: cuc ky
uncut: chua cat
upset: buon ba
unite: doan ket
utter: thot ra
usher: mo ra
uncle: chu
unify: thong nhat
unfit: khong thich hop
usurp: chiem doat
urine: nuoc tieu
united: thong nhat
unless: tru khi
uptime: thoi gian hoat dong
upheld: de cao
useful: huu ich
unique: doc nhat
update: cap nhat
unfair: khong cong bang
urgent: khan cap
upward: huong len
unlock: mo khoa
unable: khong the
unpaid: chua thanh toan
uneasy: kho chiu
upload: tai len
unused: khong su dung
unrest: bat on
unhook: thao ra
uneven: khong dong deu
unsure: khong chac chan
utmost: het suc
usable: dung duoc
unsafe: khong an toan
uptake: hap thu
unmask: vach mat
uphold: de cao
unseen: khong nhin thay
uphill: len doc
unduly: qua muc
unveil: tiet lo
unlike: khong giong
unjust: oan gia
uplink: duong len
undead: xac song
unmake: chua may
unwrap: mo ra
unmade: chua lam
uncool: coi tran
uncork: thao khoa
unfree: khong tu do
unclog: mo ra
unroll: bo cuon
untrue: khong co that
unmold: khong ban
upsize: tang kich thuoc
undies: ao lot
ureter: nieu quan
unripe: chua chin
undergo: trai qua
unusual: bat thuong
uniform: dong phuc
upright: ngay thang
upgrade: nang cap
unknown: khong xac dinh
unhappy: khong vui
unclear: khong ro
utilize: su dung
upscale: cao cap
utility: tien ich
urgency: khan cap
unequal: khong bang nhau
useless: vo ich
unheard: khong nghe
uncover: kham pha ra
unleash: giai phong
unnamed: vo danh
utterly: hoan toan
upsurge: thang tram
unitary: nhat the
uncanny: ky la
uptrend: xu huong tang
unaware: khong biet
utopian: khong tuong
unravel: lam sang to
unrated: chua duoc xep hang
unlucky: khong may
unarmed: khong co vu khi
undoing: hoan tac
upswing: nang len
ultimate: toi thuong
umbrella: o
uncommon: khong pho bien
unwanted: khong mong muon
upcoming: sap toi
unstable: khong on dinh
unlikely: khong chac
upstream: thuong nguon
unbiased: khong thien vi
unwieldy: kho di chuyen
unlawful: trai phap luat
unbilled: chua thanh toan
untapped: chua duoc khai thac
unbeaten: bat bai
uprising: cuoc noi day
unspoken: khong noi ra
unbroken: khong bi gian doan
universe: vu tru
upheaval: bien dong
underlie: chua duoc khai pha
unmarked: khong duoc danh dau
underpin: nen tang
unproven: chua duoc xac minh
uncoated: khong trang
unearned: chua duoc khai pha
unleaded: khong chi
undercut: khong noi ra
unmanned: khong nguoi lai
untested: khua duoc kiem tra
universal: pho cap
uncertain: khong chac chan
unlimited: vo han
uninjured: khong bi thuong
unwilling: khong muon
unrelated: khong lien quan
underwear: do lot
undertake: dam nhan
underwent: da trai qua
unwelcome: khong duoc hoan nghenh
unsecured: khong dam bao
undermine: huy hoai
unanimous: nhat tri
unaudited: chua duoc kiem toan
uncovered: khong che day
unmatched: vo doi
unrivaled: vo song
unpopular: khong pho bien
underbody: gam
unnoticed: khong duoc chu y
undertook: da dam nhan
unmarried: chua ket hon
untouched: khong dung cham
untypical: khong dien hinh
unnatural: khong tu nhien
untreated: chua duoc dieu tri
unplanned: ngoai ke hoach
unchanged: khong thay doi
unfailing: khong ngung
underlain: nen tang
unbounded: khong bi rang buoc
unreality: khong thuc te
unearthly: ro rang
unhurried: khong voi va
unelected: khong duoc chon
unknowing: khong biet
uppercase: chu hoa
unashamed: khong xau ho
unadorned: khong trang tri
undesired: khong mong muon
untainted: khong son
unrefined: khong tinh che
unfeeling: khong cam thay
undergrad: dai hoc
undertone: tong mau
unexpired: chua het han
ultrahigh: cuc cao
underhand: am chi
unceasing: khong ngung
unskilled: khong co ky nang
unhealthy: khong khoe manh
unruffled: khong gon song
underpass: duong chui
understand: hieu biet
underlying: co ban
understood: hieu
upbringing: nuoi duong
unforeseen: khong luong truoc duoc
unemployed: that nghiep
unpleasant: kho chiu
unfamiliar: khong quen
ubiquitous: pho cap
unanswered: khong duoc tra loi
university: truong dai hoc
unaffected: khong bi anh huong
ultimately: cuoi cung
underwater: duoi nuoc
unofficial: khong chinh thuc
ultrasound: sieu am
underneath: ben duoi
unresolved: chua duoc giai quyet
unilateral: don phuong
unreliable: khong dang tin cay
unsuitable: khong hop
unfinished: chua xong
undercover: bi mat
unexpected: bat ngo
underground: duoi long dat
undertaking: dam nhan
unfavorable: khong thuan loi
unfortunate: that khong may
uncertainty: tinh khong chac chan
unavailable: khong co san
unnecessary: khong can thiet
unpublished: chua xuat ban
undesirable: khong mong muon
unrealistic: khong thuc te
unavoidable: khong the tranh khoi
utraviolet: tia cuc tim
unthinkable: khong the tuong tuong duoc
undisclosed: khong tiet lo
unqualified: khong du tieu chuan
unspecified: khong xac dinh
undeveloped: chua phat trien
unsolicited: khong duoc yeu cau
unsurpassed: vuot troi
unwarranted: khong chinh dang
unimportant: khong quan trong
unexplained: khong giai thich duoc
unemotional: bat dinh
unprotected: khong duoc bao ve
unambiguous: ro rang
underwriter: nguoi bao lanh
unequivocal: ro rang
unconscious: bat tinh
understated: noi nho
uilitarian: thuc dung
unregulated: khong duoc kiem soat
undisturbed: khong bi xao tron
unjustified: phi ly
unrelenting: khong ngung
unpatriotic: khong yeu nuoc
unsweetened: khong duong
unorganized: khong co to chuc
uncorrected: chua sua
unglamorous: khong hai huoc
unbeknownst: khong biet
undisguised: khong nguy trang
unflappable: khong the ap dung
unrewarding: khong chuyen tiep
ultrasonics: sieu am
undersigned: ky ten duoi
unconverted: khong duoc chuyen doi
unvarnished: chua trang bi
unaddressed: khong mac quan ao
unhealthful: khong co loi
unmotivated: khong co dong co
uninsurable: khong the sua duoc
unemployment: that nghiep
unacceptable: khong the chap nhan duoc
unrestricted: khong han che
unsuccessful: khong thanh cong
unreasonable: khong hop ly
unbelievable: khong the tin duoc
unauthorized: khong duoc phep
unregistered: chua dang ky
unattractive: khong hap dan
unprofitable: khong co loi
unidentified: khong xac dinh
uncontrolled: khong kiem soat duoc
unmistakable: khong the nham lan
unprejudiced: khong thanh kien
unstructured: khong co cau truc
unacquainted: khong quen biet
underpinning: nen tang
unproductive: khong hieu qua
unpublicized: khong cong bo
unobservable: khong the quan sat duoc
unreflective: khong hoat dong
unreconciled: khong duoc ghi lai
unsuspecting: khong nghi ngo
unassociated: khong lien ket
unrepeatable: khong the lap lai
unpardonable: khong the tha thu
unparalleled: vo song
unlikelihood: khong co kha nang
unresolvable: khong the giai quyet
uninfluenced: khong co rao can
underlayment: lop lot
underclothes: quan ao lot
unverifiable: khong the kiem chung
unforgettable: khong the nao quen
unprecedented: chua tung co
undissociated: khong phan ly
unpredictable: khong the doan truoc
unenforceable: khong the thi hanh
uninterrupted: khong bi gian doan
understanding: hieu het
unconditional: vo dieu kien
unanticipated: khong luong truoc
uncomplicated: khong phuc tap
uncomfortable: kho chiu
unintentional: khong co y
unsustainable: khong ben vung
unconceivable: khong the tuong tuong duoc
uncalculating: khong tinh toan
underestimate: danh gia qua thap
unconformable: khong phu hop
unsusceptible: khong the nhan ra
unsatisfactory: khong dat yeu cau
unintelligible: kho hieu
uncompromising: khong khoan nhuong
ultrastructure: sieu cau truc
unconventional: khac thuong
underdeveloped: kem phat trien
undomesticated: khong co tinh vi
understandable: co the hieu duoc
unquestionable: khong the nghi ngo
uncontrollable: khong kiem soat duoc
unidentifiable: khong xac dinh duoc
unidirectional: mot chieu
universalistic: pho quat
undersecretary: duoi thu ky
unconscionable: vo luong tam
understatement: su noi nho
utilitarianism: thuyet vi loi
underpopulated: dan so it
uncontaminated: khong bi o nhiem
undernutrition: thieu dinh duong
ultraminiature: sieu nho
unappreciative: khong tan thuong
unchivalrously: phi thuong
unexceptionably: khong the chap nhan duoc
uncompromisable: khong khoan nhuong
underprivileged: kem coi
unsophisticated: khong phuc tap
unchallengeable: khong the thach thuc
undistinguished: khong phan biet
uncontroversial: khong doi nghich
unsportsmanlike: phi the thao
unprepossessing: khong chuan bi
unpronounceable: khong the phat am
unsubstantiated: khong co can cu
uncommunicative: khong thong thao
undemonstrative: khong bat buoc
ultrafiltration: sieu loc
ultrasonography: sieu am
unparliamentary: khong co nghi vien
unpronounceable: khong the phat am
ultracentrifuge: sieu ly am
unexceptionable: khong the chap nhan duoc
unaccommodating: khong thoai mai
ultramicroscope: kinh hien vi sieu nho
unsettlednesses: bat on
unobjectionable: khong the choi cai
Understand:hieu
veer: xoay quanh
view: luot xem
vote: bo phieu
veil: mang che mat
very: rat
vary: khac nhau
void: vo hieu
visa: ho chieu
veal: thit be
vice: hanh vi xau xa
vine: cay nho
vein: tinh mach
vest: ao vest
veto: phu quyet
vail: thung
vain: vo ich
vent: lo thong hoi
vase: cai binh hoa
verb: dong tu
vibe: rung cam
vast: rong lon
volt: von
vial: lo
vane: canh gat
vile: hen ha
value: gia tri
video: video
voter: cu tri
visit: chuyen tham
valid: co hieu luc
venue: hoi hop
viral: lan toa
voice: tieng noi
villa: biet thu
vague: mo ho
vocal: giong hat
venom: noc doc
valve: van
vital: quan trong
verse: tho
vapor: hoi
vivid: song dong
verge: bo vuc
vigil: canh giac
vinyl: nhua
vogue: thinh hanh
virus: vi rut
vigor: suc song
vying: tranh gianh
vault: kho tien
valet: nguoi hau
vodka: ruou vodka
voodoo: thu
volume: am luong
vision: tam nhin
vendor: nguoi ban hang
victor: nguoi chien thang
valley: thung lung
victim: nan nhan
varied: da dang
visual: truc quan
virgin: trinh nu
viable: kha thi
virtue: duc hanh
vessel: tau
veneer: van lang
vacuum: may hut bui
vacant: bo trong
verbal: bang loi noi
vested: duoc trao
venous: tinh mach
voiced: long tieng
versus: dau voi
velvet: nhung
voyage: hanh trinh
violin: dan vi o long
verify: kiem chung
viewer: nguoi xem
vulgar: tho tuc
vanish: tan bien
vigour: suc song
veiled: che kin mat
verity: chan that
vortex: xoay nuoc
vanity: tu phu
versed: thanh thao
violet: mau tim
volley: chuyen
vapour: hoi nuoc
variety: da dang
village: lang
virtual: ao
venture: lien doanh
vehicle: phuong tien
villain: nhan vat phan dien
visible: co the nhin thay
various: da dang
veteran: cuu chien binh
version: phien ban
victory: chien thang
violent: hung bao
variant: bien the
voltage: von
visitor: khach tham quan
vintage: co dien
voucher: chung tu
vitamin: vitamin
vibrant: soi dong
vaccine: vac xin
vacancy: vi tri tuyen dung
vicious: luan quan
violate: xam pham
verdict: phan quyet
viewing: dang xem
vantage: thuan loi
vinegar: giam
volcano: nui lua
violence: bao luc
vertical: theo chieu doc
vitality: suc song
volatile: bay hoi
velocity: van toc
valuable: quy gia
vacation: ky nghi
volcanic: nui lua
vigorous: manh me
variable: bien doi
vascular: mach mau
virtuous: duc hanh
vicinity: lan can
validate: xac nhan
visceral: noi tang
vanguard: doi tien phong
vigilant: canh giac
varietal: giong nhau
vocation: cong viec
vineyard: vuon nho
virtuoso: dieu luyen
verbatim: nguyen van
vocalist: giong ca
variance: phuong sai
virulent: doc hai
vignette: hoa tiet
vaulting: kho tien
vulgarity: tho tuc
voluntary: tinh nguyen
variation: bien the
vengeance: su bao thu
valuation: dinh gia
versatile: linh hoat
viewpoint: quan diem
virtually: hau nhu
vegetable: rau
videotape: bang video
vibration: rung dong
violation: su vi pham
valentine: le tinh nhan
voracious: tham an
vandalism: su pha hoai
visualize: hinh dung
visionary: nhin xa trong rong
viscosity: do nhot
vigilance: canh giac
volunteer: tinh nguyen vien
veritable: thuc su
vehicular: xe co
vindicate: minh oan
virginity: trinh tiet
voiceless: vo thanh
vicarious: tuong doi
venerable: dang kinh
vermilion: mau do son
vivacious: hoat bat
vertebral: dot song
vestibule: tien dinh
ventricle: tam that
vigilante: nguoi canh giac
visibility: hien thi
vocational: nghe
viewership: luong nguoi xem
veterinary: thu y
vulnerable: de bi ton thuong
vegetarian: an chay
vestibular: tien dinh
volleyball: bong chuyen
vocabulary: tu vung
victorious: chien thang
vindictive: thu han
verifiable: co the kiem chung
voluminous: do so
villainous: phan dien
vertebrate: dong vat co xuong song
vasoactive: hoat huyet
vociferous: to tieng
virtuosity: ky thuat dieu luyen
ventilator: may tho
vaudeville: tap ky
victimless: nan nhan
variegated: loang lo
viewfinder: kinh ngam
veneration: su ton kinh
vermicelli: bun tau
volumetric: the tich
vegetation: tham thuc vat
videophone: cuoc goi video
visitation: tham vieng
viscometer: may do do nhot
vegetative: thuc vat
vibraphone: rung
visualizer: trinh hien thi
vasculitis: viem mach
voiceprint: giong noi
villainess: tinh xau xa
vernacular: tieng dia phuong
volatilize: bay hoi
vitrectomy: cat dich kinh
ventilation: thong gio
ventricular: tam that
venturesome: thich mao hiem
vinaigrette: giam
vindication: su minh oan
variability: su thay doi
vertiginous: chong mat
voluntarism: tinh nguyen
viscountess: nu tu tuoc
vaccination: tiem chung
valediction: dinh gia
viticulture: nghe trong nho
videography: quay phim
vasodilator: thuoc gian mach
valedictory: thu khoa
vivisection: hinh dung
vasculature: mach mau
victimology: nan nhan
viceroyalty: long trung thanh
volunteerism: tinh nguyen
voluntaryism: chu nghia tu nguyen
ventromedial: nao that
veterinarian: bac si thu y
vainglorious: hay khoe khoang
verification: xac minh
vitalization: su song lai
vasodilation: gian mach
velociraptor: van toc
vaticination: su say me
venipuncture: chich tinh mach
vacationland: ky nghi
viscosimeter: may do do nhot
virtuosities: ky thuat dieu luyen
vituperation: chui rua
verticillate: doc
viruliferous: con trinh
valetudinary: nguoi hau
visitatorial: tham kham benh
virtuousness: duc hanh
viscometries: nhot ke
verbigeration: xung quanh
vegetarianism: an chay
vocationalism: chu nghia nghe nghiep
vermiculation: vi khuan
valedictorian: thu khoa
verbosenesses: do dai
veraciousness: y thuc
ventrolateral: ben bung
verisimilarly: tuong tu
verifiability: kha nang xinh minh
verticalities: doc
vociferations: tieng noi
voluntaryisms: su tu nguyen
verbalization: loi noi
vertiginously: dai dong
versatilities: su tuong dong
voluntaristic: tu nguyen
versatileness: tinh linh hoat
venturesomely: mao hiem
versification: su linh hoat
venturousness: tinh mao hiem
volcanologies: nui lua
verifications: xac minh
vocalizations: giong noi
volunteerisms: tinh nguyen
voluntaryists: nhung nguoi tu nguyen
veritableness: tinh chan mat
volcanicities: nui lua
voraciousness: pham an
vesiculations: mun nuoc
volcanologist: nha nui lua hoc
voicelessness: vo thanh
vouchsafement: xac nhan
volatilizable: de bay hoi
volublenesses: do hoa tan
virologically: ve mat virus
vandalizations: pha hoai
valuablenesses: gia tri
variablenesses: su thay doi
valetudinarian: nguoi hau
ventriloquized: noi tieng bung
vasodilatation: gian mach
verifiableness: kha nang xac minh
verticalnesses: do thang dung
vaporishnesses: su boc hoi
vesicularities: mun nuoc
veridicalities: nhung thoi quen
vasoactivities: hoat dong mach
verbalizations: loi noi
valedictorians: thu khoa
ventriloquists: nguoi noi tieng bung
versifications: su thay doi
vermiculations: che pham sinh hoc
vegetativeness: sinh duong
vegetarianisms: nguoi an chay
vouchsafements: bao dam
vivisectionists: nhung nguoi theo chu nghia tuong tuong
verifiabilities: xac minh trach nhiem phap ly
viscoelasticity: tinh nhot deo
vasodilatations: gian mach
videoconference: cau truyen hinh
valuelessnesses: vo gia tri
vasoconstrictor: thuoc co mach
vicissitudinous: thang tram
valetudinarians: nguoi hau
vicariousnesses: nan nhan
voyeuristically: man nhan
versatilenesses: tinh linh hoat
veraciousnesses: y thuc
veritablenesses: thuc su
venturesomeness: tinh mao hiem
vexatiousnesses: kho chiu
venerablenesses: dang kinh
ventriloquially: noi tieng bung
vivaciousnesses: hoat bat
vocationalisms: day nghe
volatilizations: bay hoi
voicelessnesses: vo thanh
voluntarinesses: su tu nguyen
visionarinesses: tam nhin xa trong rong
vulnerabilities: lo hong bao mat
volatilization: bay hoi
voicefulnesses: giong noi
voidablenesses: tinh vo hieu
voluminosities: hoi luong
voraciousnesses: pham an
volatilenesses: tinh de bay hoi
volumetrically: ve mat the tich
vascularization: mach mau
voluminousness: do so
volcanologists: cac nha nui lua hoc
voluptuousness: su goi cam
volcanological: nui lua
youth: tuoi tre, tuoi xuan, tuoi thanh nien, tuoi nien thieu
your det: cua anh, cua chi, cua ngai, cua may; cua cac anh, cua cac chi, cua cac ngai, cua chung may
yard: lat, thuoc anh (bang 0, 914 met)
yeah exclamation: vang, u
yet: con, hay con, con nua; nhu ma, xong, tuy the, tuy nhien
year: nam
yellow: vang; mau vang
you pro: anh, chi, ong, ba, ngai, nguoi, may; cac anh, cac chi, cac ong, cac ba, cac ngai, cac nguoi, chung may
yes exclamation: vang, phai, co chu
yesterday: hom qua
young: tre, tre tuoi, thanh nien
yours pro: cai cua anh, cai cua chi, cai cua ngai, cai cua may; cai cua cac anh, cai cua cac chi, cai cua cac ngai, cai cua chung may
yawn: ha mieng; cu chi ngap
yourself pro: tu anh, tu chi, chinh anh, chinh may, tu may, tu minh
yo: chao! nay! (dung de chao hoi hoac luu y ai)
yd: thuoc anh (don vi do chieu dai)
yap: (cho nho) sua ang ang
yet: chua
you: ban
yob: thanh nien con do, nguoi du dan
yes: vang
your: cua ban
yang: duong
yell: la len
yeah: vang
yoke: ach, phien go dai gac len co cac hai con vat (trau, bo…) de chung cung keo vat gi nang​
yard: san
year: nam
yuan: nhan dan te
yoga: yoga
yarn: soi chi, soi len
youth: thieu nien
yield: san xuat, sinh ra
yarns: soi
yonks: thoi gian dai
yawls: ngap
yuppy/ yuppies: thanh nien o thanh pho, co nghe chuyen mon, kiem tien va xai nhieu tien
yours: cua ban
young: tre
yacht: thuyen buom
yeast: men (de lam ruoi, bia, banh my
yearn: khao khat, mong moi
years: thoi gian dai, lau nam
yummy: ngon ngon
yawns: ngap
yikes: yeu dieu
yield: san luong, hoa loi
yellow: mau vang
yeasty: khoa truong
yearly: hang nam
yenned: yen tam
yoghurt/yogurt: sua chua
yeuked: yeu thich
yucking: het len
yardman: nguoi lam san
yearling: khao khat
youthful: tre trung
yourself: ban than ban
yeomanry: phong thuy
yielding: nang suat
yeanling: de con
yearlong: keo dai
youngish: tre trung
yearning: khao khat
yardbird: chim son ca
yearbook: nien giam
yachting: mon the thao dua thuyen buom
yellowing: o vang
yappingly: ngap
yesterday: hom qua
yawmeters: ngap
yearnings: khao khat
yeastless: khong men
yeastiest: dep nhat
yearlings: nam con
yachtsmen: nguoi dan ong dieu khien thuyen buom (trong cuoc dua hoac cuoc choi)
yeastlike: giong nhu men
yellowest: mau vang nhat
yachtswoman: nguoi phu nu dieu khien thuyen buom (trong cuoc dua hoac cuoc choi)
yachting: mon the thao dua thuyen buom​
yellowish: hoi vang, vang vang
yawningly: ngap
yardbirds: chim san
yabbering: tieng keu
yearbooks: ky yeu
yardworks: san bai
yardstick: tieu chuan de so sanh
yardlands: san dat
yuckiness: kinh ngac
youngberry: dau non
yellowtail: duoi vang
yardmaster: chu san
yesteryear: nam qua
yourselves: ban than cac ban
yellowwood: go mau vang
yellowlegs: chan vang
yearningly: khao khat
yellowfins: soi vang
yesterdays: nhung ngay qua
yellowware: do vang
younglings: con non
yeomanries: nam men
youngsters: thanh nien
yardsticks: thuoc do
yeastiness: su tinh than
youthquake: tuoi tre
yellowwoods: go vang
youngnesses: tuoi tre
yardmasters: nguoi quan ly san bai
yellowtails: mau vang
yellowwares: do vang
youthfulness: su tre trung
yesternights: nhung dem qua
youngberries: qua non, qua xanh
yellowthroats: mau vang
yellowhammers: chim san vang
youthfulnesses : su tre trung
yellow line: vach ke mau vang (o le duong, cho biet chi co the dau xe trong thoi gian han che)
the yellow pages: cac trang vang (trong danh ba dien thoai, de quang cao)
yet another: lai tiep tuc
yellow card: the vang (de canh cao la se duoi neu choi xau lan nua) (trong bong da)
yha: hiep hoi ky tuc xa thanh nien
youth hostel: nha tro gia re danh cho thanh nien
yet again: lai mot lan nua
yet to do: chua duoc hoan tat
wed: thu tu
who: ai
wax: sap
way: duong
won: da thang
win: chien thang
was: da
web: website
why: tai sao
wet: uot
woo: gau gau
wee: mot chut
war: chien tranh
wow: wow
wit: muu meo
wis: khon ngoan
wry: nhan nho
word: tu ngu
were: la
wife: nguoi vo
what: cai gi
well: tot
with: voi
want: muon
went: da di
will: se
work: cong viec
when: khi nao
west: cach
week: tuan
ways: cach
wider: rong
wire: day dien
wall: tuong
whom: ai
which: cai nao
where: o dau
wrote: da viet
world: the gioi
women: dan ba
whole: toan bo
while: trong khi
whose: ai
would: se
white: trang
write: viet
water: nuoc
wrong: sai lam
watch: dong ho deo tay
worth: dang gia
wisdom: su khon ngoan
worthy: xung dang
within: trong
weight: can nang
window: cua so
winter: mua dong
writer: nha van
wooden: bang go
wealth: su giau co
wonder: ngac nhien
wholly: hoan toan
walker: nguoi di bo
winner: nguoi chien thang
weapon: vu khi
weekly: hang tuan
wright: van veo
worker: cong nhan
whilst: trong khi
whereas: trong khi
without: khong co
website: trang mang
weekend: ngay cuoi tuan
written: bang van ban
winning: chien thang
whether: lieu
working: dang lam viec
waiting: dang cho doi
walking: di dao
welcome: chao mung
writing: viet
western: mien tay
weather: thoi tiet
willing: san long
wardrobe: tu quan ao
wreckage: dong do nat
wireless: khong day
wherever: bat cu noi nao
warranty: su bao dam
weakness: yeu duoi
whatever: bat cu dieu gi
woodland: rung cay
watchdog: nguoi canh gac
withdraw: rut lui
workload: khoi luong cong viec
wildlife: dong vay hoang da
workflow: quy trinh lam viec
workshop: xuong
weighted: co trong luong
wrapping: goi
workable: kha thi
whenever: bat cu dieu gi
workbench: ban lam viec
wonderful: tuyet voi
whichever: nao
wholesale: ban si
whitehead: toc trang
wondering: tu hoi
workplace: noi lam viec
withstand: chiu duoc
whereupon: tu do
worldwide: tren toan the gioi
wrestling: dau vat
wallpaper: hinh nen
worthless: vo gia tri
warehouse: kho
webmaster: quan vi vien web
waterfall: thac nuoc
withdrawn: tut lai
watershed: dau nguon
whirlpool: xoay nuoc
whirlwind: gio loc
weathered: phong hoa
wholesome: lanh manh
whimsical: hay thay doi
wasteland: dat hoang
watertight: kin nuoc
worthwhile: dang gia
watercress: cai xoong
wastewater: nuoc thai
wilderness: hoang vu
witchcraft: phu thuy
wheelchair: xe lan
wavelength: buoc song
widespread: pho bien rong rai
waterproof: khong tham nuoc
withdrawal: rut tien
watercraft: tau thuy
whatsoever: bat cu dieu gi
watercolor: mau nuoc
wonderland: xu so than tien
weathering: phong hoa
waterfront: bo song
windshield: kinh chan gio
waterworks: cong trinh nuoc
workaholic: tham cong tiec viec
windscreen: kinh o to
woodpecker: chim go kien
wristwatch: dong ho deo tay
wintergreen: mua dong xanh
withholding: khau tru
workmanship: tay nghe
wastebasket: thung rac
woodworking: che bien go
waitressing: hau ban
windsurfing: luot van
workstation: may tram
waterlogged: ung nuoc
whereabouts: noi o
westernmost: cuc tay
wheelwright: tho lam banh xe
wheelbarrow: xe cut kit
workmanlike: cong nhan
wearability: kha nang mac
weatherizing: phong hoa
wholehearted: het long
weatherproof: thoi tiet
workingwoman: phu nu lam viec
weathercasts: du bao thoi tiet
whimsicality: tinh hay thay doi
waterfowling: chim nuoc
weatherglass: kinh thoi tiet
wherethrough: qua
weatherboard: bang thoi tiet
whortleberry: cay nham le
warehouseman: nhan vien kho hang
withoutdoors: khong co ngoai troi
welterweight: trong luong han
weightlessly: khong trong luong
weathercocks: thoi tiet
whitewashings: tay trang
whipstitching: roi da
wheelbarrowed: xe cut kit
willfulnesses: y chi
wistfulnesses: bang khuang
winsomenesses: nhung loi ich
willingnesses: su san long
whithersoever: tuy nhien
winterberries: qua viet quat
winterization: dong hoa
wishfulnesses: mo uoc
wholesomeness: tinh lanh manh
wimpishnesses: tinh xau
whimsicalness: hay thay doi
withdrawnness: su rut lui
witlessnesses: su khon ngoan
winterfeeding: cho an dong
wonderfulness: su tuyet voi
wordlessnesses: khong loi
worshipfulness: su ton tho
whortleberries: qua viet quat
winglessnesses: khong co canh
watchfulnesses: canh giac
wheelbarrowing: xe cut kit
workablenesses: tinh kha thi
whimsicalities: hay thay doi
womanishnesses: phu nu
worklessnesses: that nghiep
wholeheartedly: het long
worthwhileness: dang gia
watercolorists: mau nuoc
wondrousnesses: su ky dieu
wonderfulnesses: su tuyet voi
weatherboarding: luot van
weatherproofing: thoi tiet
westernisations: phuong tay hoa
wearisomenesses: met moi
worthlessnesses: nhung dieu vo gia tri
weatherizations: phong hoa
warmheartedness: long nhan hau
Improve:cai thien
Communicate:giao tiep
Attend:tham du
Continue:tiep tuc
Announce:thong bao
Revise:on tap
Enroll:nhap hoc
Succeed:thanh cong
Memorise:hoc thuoc
Call:goi (ai, la gi)
Know:biet
Tell:ke (cho ai)
Spell:danh van
Live:sinh song
Describe:mieu ta
Sign:ky ten
Open:mo (mot dich vu)
Offer:de xuat
Design:thiet ke
Prepare:chuan bi
Arrange:sap xep
Manage:quan ly
Spend:tieu tien
Save:tiet kiem
Borrow:muon
Owe:no
Lend:cho vay
Raise:tang
Decrease:giam
Throw:nem
Lack:thieu
Build:xay
Face:huong ve
Decorate:trang tri
Share:chia se
Inform:bao tin
Develop:phat trien
Invite:moi
Book:dat cho
Escape:tron khoi
Experience:trai nghiem
Discover:kham pha
Try:thu
Recommend:de xuat
Taste:nem thu
Hike:di bo duong dai
Pray:cau nguyen
Party:tiec tung
Welcome:hoan nghenh
Tidy:don dep
Exchange:trao doi
Expect:mong doi
Respect:ton trong
Believe:tin
Mean:co y dinh
Surprise:lam bat ngo
Control:dieu khien
Avoid:tranh
Persuade:thuyet phuc
Approach:tiep can
Forecast:du bao
Last:keo dai
Boil:luoc
Grill:nuong
Prepare:chuan bi
Stir-fry:xao
Serve:phuc vu
Pour:rot
Stir:khuay
Add:them
Roast:nuong bo lo
Follow:tuan theo
Stay:giu nguyen
Snack:an vat
Breathe:tho
Mix:tron
Spoil:bi hong
Plant:trong
Harvest:thu hoach
Pickle:muoi chua
Explore:kham pha
Grow:lon len
Protect:bao ve
Rely:dua dam
Surround:bao quanh
Sunbathe:tam nang
Care:quan tam
Exercise:tap the duc
Damage:pha hong
Prevent:phong tranh
Remain:giu nguyen
Injure:gay thuong tich
Bleed:chay mau
Hurt:lam bi dau
Suffer:chiu dung
Ease:xoa diu
Consider:can nhac
Admit:thua nhan
hello: xin chao
hi: chao ban
thanks: cam on ban
thank you: cam on ban
me: toi
you: ban
they: ho
we: chung ta
he: anh ay
she: co ay
it: no
handsome: Thanh Hung
smart: Thanh Hung
rich: Thanh Hung
powerful: Thanh Hung
binary: nhi phan
 
